CTATCGGGTCTCAACA-1	Fibroblasts
TCGAGACCAACACCGT-1	Fibroblasts
GATGCGTCCTGCATTC-1	Fibroblasts
GCATAGAGCACTCAGG-1	Neural
GCAGATTAGGGATATC-1	Neural
CAATTTCGTATAAGGG-1	Neural
CCAGCCTGGACCAATA-1	Fibroblasts
ATGGAGCAGGCCGTGA-1	Fibroblasts
GTCATTAGAGCGAACG-1	Fibroblasts
AAGACTGCAAGCTACT-1	Endothelial
CTAGTCACGTCTTAAG-1	Fibroblasts
ACTCTTGTATAGTAAC-1	Fibroblasts
GAAGTGATTTATCGTG-1	Neural
CCACACTGAGATATTA-1	Muscle
CGATCCGACCCAGTGC-1	Fibroblasts
CTGTACTTCTTAGCAT-1	Fibroblasts
ACTTATTAGGATCGGT-1	Neural
TAGTCCGCAGAGAATG-1	Fibroblasts
TTCACGAAAGGATCAC-1	Muscle
TACATTTCTAACGTGC-1	Fibroblasts
ACCATATCCGCAATAA-1	Fibroblasts
CACTCAAGAGCTATGG-1	Fibroblasts
TGTACGAACAAATCCG-1	Fibroblasts
ATCATCCAATATTTGT-1	Fibroblasts
CGCTATTCTTAGGCTC-1	Fibroblasts
TGGCAGCAGTAATAGT-1	Fibroblasts
TCACGTGCCCGATTCA-1	Neural
CATACGGCGTCTGGGC-1	Fibroblasts
CACATGATTCAGCAAC-1	Muscle
GCTAGTAGAGCTTGTA-1	Fibroblasts
TGCTGTTGAAGAACTC-1	Neural
CGGAGCATGGCGATCC-1	Muscle
TAGCGTTGGGTCTTAC-1	Fibroblasts
GTAGCGGCTATACACT-1	Neural
TAACATACAATGTGGG-1	Fibroblasts
TCTTCGAATAGACGTT-1	Fibroblasts
TCCTAGCAAAGAAGCT-1	Neural
GATGTTCAATCCACGA-1	Fibroblasts
AGTTAAACACTTGCGA-1	Neural
AGCTCTTTACTCAGTT-1	Fibroblasts
ATCCAGGATTCGTGAA-1	Fibroblasts
AGTCAACACCACCATC-1	Fibroblasts
CGATACCTCGCGGACA-1	Fibroblasts
TACAACGCACAACTCA-1	Myofibroblast_Mesothelium
AATTAAAGGTCGGCGT-1	Fibroblasts
TACGCAGTTCTTTCCT-1	Fibroblasts
GACCGTGCTGACGGTG-1	Fibroblasts
GGCAAATTACTTTACT-1	Fibroblasts
GGTACAAACATGCTAT-1	Endothelial
CGGGCCTTCTTTGTAA-1	Myofibroblast_Mesothelium
CGTGAAGTTAATTCAC-1	Fibroblasts
ATAGTGAAGCGTTCTC-1	Fibroblasts
TACGCCATATTCTAAT-1	Fibroblasts
GCCGGGTTAGGGTCGC-1	Epithelial
TACATAGGCATACACC-1	Fibroblasts
GCCGATTGGCCAAGCT-1	Myofibroblast_Mesothelium
CTGCCATGCATCACAT-1	Fibroblasts
TTATGAATGAAAGGGA-1	Fibroblasts
GCTGAGGCGTGAGTAT-1	Fibroblasts
GCGCCGTTCCACGATA-1	Fibroblasts
CGCATGGTGCGATGCT-1	Fibroblasts
AGGTTTCACACACCTT-1	Fibroblasts
CAAGGATCGCATGTTC-1	Muscle
ACGTTAATGTCGAAGA-1	Muscle
TCCAGAGCACCGGTTC-1	Fibroblasts
GATTCGACGGTTCACG-1	Fibroblasts
GTTTCTGCAGTCTCCC-1	Fibroblasts
GCTGCACGGTTTCTTA-1	Fibroblasts
GTGTTACTATGCGTCC-1	Fibroblasts
CTCCGCCCACATGAGG-1	Fibroblasts
GTTGAACCGGTTCCAT-1	Neural
TTGACTACCATATGGT-1	Fibroblasts
ACCATCGTATATGGTA-1	Fibroblasts
TGCGTAAGAACCTGAT-1	Endothelial
AGAAGGTTGCCGAATT-1	Fibroblasts
AGGACGACCCATTAGA-1	Myofibroblast_Mesothelium
GGTGCTGGTACACATT-1	Myofibroblast_Mesothelium
GCGCTATGCCGAGGCA-1	Epithelial
ACCCGGTTACACTTCC-1	Myofibroblast_Mesothelium
TAACTCATCCGCGCGG-1	Epithelial
CACAATGAGCTGCTAT-1	Epithelial
GTTACTTTGGGCCTAG-1	Epithelial
GGGCCCGTCTTAAACA-1	Epithelial
GAAATTGTCTCTATAA-1	Epithelial
GGCGCATGAATTGATG-1	Myofibroblast_Mesothelium
CATATAGGTACAGTCA-1	Epithelial
TCAACGAGGAGACAAA-1	Epithelial
TTGCACAATTCAGAAA-1	Epithelial
CATCGGACGGGTTAAT-1	Epithelial
ATTAAACATGCGGACC-1	Epithelial
TATCTACCACAGCGGG-1	Myofibroblast_Mesothelium
CGAGACCCTAGAGTGT-1	Epithelial
ACATCGATCGTTTACC-1	Myofibroblast_Mesothelium
ATCGACCCAATACAGA-1	Myofibroblast_Mesothelium
GAATCTGAACATTCTC-1	Fibroblasts
AGTTCCTATTTATGTT-1	Fibroblasts
CAGTCTGTATACTGGG-1	Fibroblasts
GGAGACGACACCTTTG-1	Fibroblasts
CCTAAATTAACGGTTC-1	Fibroblasts
GCTACGACTTATTGGG-1	Neural
CTGTGCAGGGTAGGTC-1	Fibroblasts
ACGCCGCTAGACGACC-1	Fibroblasts
ACTTGACTCCCTCTTT-1	Fibroblasts
CGCCTCCCTCCTCTAT-1	Fibroblasts
TTGAGAGTACTGCTAA-1	Neural
GCCACAATTTAAGGAC-1	Fibroblasts
ATATTCAGTTAAACCT-1	Fibroblasts
TGAGTGCCTCTTAAAT-1	Fibroblasts
ATCAGACGGCACGCCG-1	Myofibroblast_Mesothelium
GTGCGAAATCGAACAC-1	Myofibroblast_Mesothelium
GTGCCGCTTCAAAGGT-1	Myofibroblast_Mesothelium
GATACGATGGGAGTCA-1	Myofibroblast_Mesothelium
GACACTGAGTTCAGTG-1	Epithelial
ATCCTGCGTGGAATGG-1	Epithelial
ATCCTACCTAAGCTCT-1	Epithelial
AGTGATATGAGTAGTT-1	Epithelial
ATGATGCAATGGTACA-1	Epithelial
GAAACCGAATTACCTT-1	Epithelial
AGTGACCTACTTTACG-1	Epithelial
CAAATGTCCTTCCGTG-1	Epithelial
TTACTGGGATATTTCA-1	Epithelial
CTTGCCCAGGCTCTAC-1	Epithelial
AAATCGTGTACCACAA-1	Epithelial
GTGATCATAGATCTGC-1	Epithelial
TGGCAGATTACGATCA-1	Epithelial
TCACCCTCTTAAGATT-1	Epithelial
CAGGATATATCGTTGT-1	Fibroblasts
CCTGACCACCGATGGT-1	Epithelial
CTAAAGGGAAATAGGA-1	Epithelial
CCGCTATCAGCACCAG-1	Myofibroblast_Mesothelium
CTTTAGTGCTATTATT-1	Myofibroblast_Mesothelium
CGGGAATTTATGTAAA-1	Fibroblasts
TACGACTGCCTCTTAG-1	Fibroblasts
AAACTGCTGGCTCCAA-1	Fibroblasts
GTACGTTTGCCCGTCA-1	Fibroblasts
GGCAAGGCGAAATAGC-1	Muscle
GATCTTGGAGGGCATA-1	Neural
AGCGTGGTATTCTACT-1	Fibroblasts
CTAAGGGAATGATTGG-1	Fibroblasts
ATCACGTGCTAATTAA-1	Epithelial
GGTGAAGTACAGGGAT-1	Fibroblasts
GCTGTATTACTGGCCC-1	Fibroblasts
AACGGCCATCTCCGGT-1	Fibroblasts
TAAGTAACATCTTGAC-1	Endothelial
TTCTTGAGCCGCGCTA-1	Fibroblasts
AGTGCGTAGCTCGTAA-1	Myofibroblast_Mesothelium
GGGATGGTCGTAACCG-1	Myofibroblast_Mesothelium
GTCTGGGCGGTCGAGA-1	Myofibroblast_Mesothelium
CGGAACGTAAACATAG-1	Epithelial
TGCGACACCCTAGTGC-1	Epithelial
CAAACGAGTATCGCAG-1	Epithelial
TCAGTAGGGACTATAA-1	Epithelial
GCGGTTCCCTATCATG-1	Epithelial
GTGACTTCAGTAGTGC-1	Epithelial
CGTCACGTCCATTGGT-1	Epithelial
ATAAGTTACCGCGACG-1	Epithelial
CTGAATCCGAGACCTC-1	Epithelial
TACGACGCTTGCTGCG-1	Epithelial
GAATTCACCCGGGTGT-1	Epithelial
GGGTGACACCTTAACT-1	Epithelial
TGAGTAAATTAGCGTA-1	Epithelial
GAGTCCGCTTACCGGA-1	Epithelial
GGCGCGTTCGAGTTTA-1	Epithelial
ATTCATATACTGTCCA-1	Epithelial
ATAAACGGACCCGTAA-1	Fibroblasts
GTCGTACCATCTCGGG-1	Myofibroblast_Mesothelium
ATAATAGCTGTTGAAT-1	Myofibroblast_Mesothelium
TTCCGCGTGAGGCGAT-1	Myofibroblast_Mesothelium
TACCGGCTCACTGCCC-1	Myofibroblast_Mesothelium
GTATCTTTCATAACCA-1	Fibroblasts
GTTACCTACAACTTGC-1	Fibroblasts
TGACTATAATCCTTTC-1	Fibroblasts
AAATACCTATAAGCAT-1	Neural
TTATTAGAGCGTGTTC-1	Fibroblasts
ATGTGGACATCTTGAT-1	Fibroblasts
GTACGCTTCATTGCAC-1	Fibroblasts
CACATATTAGCAGGAT-1	Fibroblasts
CAAGAGGGCGGAGTAC-1	Fibroblasts
TCGCAAAGATGCATTT-1	Fibroblasts
GTCGTTATTCGCTTAT-1	Fibroblasts
CGGTGCGCGTTGGTCC-1	Muscle
GTGATTCGCCGCTCAA-1	Fibroblasts
GCCCGCGCGTAAACGG-1	Fibroblasts
AACGTACTGTGGGTAC-1	Myofibroblast_Mesothelium
GAGTATGCCCGCCTTG-1	Myofibroblast_Mesothelium
TGATTCTGTCGCCGGT-1	Epithelial
GGGCGGCAAATGAATT-1	Myofibroblast_Mesothelium
TTCCAATCTGGCTATC-1	Epithelial
GGAACCGTGTAAATTG-1	Epithelial
TTGGTCACACTCGTAA-1	Epithelial
CGAACCCGCATGCGTC-1	Epithelial
GGGCGTCACCACGTAA-1	Epithelial
TACCAGAAGTAGGTTC-1	Epithelial
TTGGATATCGTCTACG-1	Epithelial
TAGATATGGACTGGAA-1	Epithelial
GCGACGATAGTTGTAC-1	Epithelial
CTGGATTTACACTTGA-1	Epithelial
GTTATATTATCTCCCT-1	Epithelial
TATTCCACTCAGCTCG-1	Epithelial
CTGTTACCCAATCTAG-1	Epithelial
ACGCGAAGTCAGACGA-1	Myofibroblast_Mesothelium
GATAGGTAACGTTGAC-1	Epithelial
TGTTCGTATTGCGGTG-1	Fibroblasts
GGTCAGTGGGTCCCAC-1	Myofibroblast_Mesothelium
AATTCTAGAGTTAGGC-1	Epithelial
GTTTACGTTCCATCTG-1	Myofibroblast_Mesothelium
AGACCCACCGCTGATC-1	Fibroblasts
TCTAGCATGCCCAGAA-1	Fibroblasts
CCCGCAGCGCGAACTA-1	Fibroblasts
CTCTATTTGGCTGCAG-1	Fibroblasts
TTCTGCCGCGCCTAGA-1	Muscle
ACTCCCTAGAATAGTA-1	Fibroblasts
CCGAACCTTCCCGGCC-1	Fibroblasts
TCAGACGCTATAGAAG-1	Neural
CAGGCGCCATGCTAGG-1	Endothelial
CACTCGAGCTGAACAA-1	Fibroblasts
ACAAGGAAATCCGCCC-1	Fibroblasts
ACCACGTGCAGCTATA-1	Fibroblasts
ACGGCGACGATGGGAA-1	Fibroblasts
ACAGGTGGAGGTGAGG-1	Neural
TGCGAGAATATTACCC-1	Fibroblasts
TTGCGTCGGCCAACCG-1	Fibroblasts
AGGCTTCCCGAAGAAG-1	Fibroblasts
GCGGACCGCGTTGTGG-1	Endothelial
GTAATCTGATTCTTCG-1	Myofibroblast_Mesothelium
CCGCGGAATGCGTCAC-1	Myofibroblast_Mesothelium
TTCCACACAGATTTGA-1	Epithelial
CTTCTATTAATGCTAG-1	Fibroblasts
CATTTGAGTGGTACGT-1	Epithelial
TCACAGCAAACTCGAA-1	Epithelial
CAGACGAACCTGATAC-1	Epithelial
TAGCTAGAAGGCATGA-1	Epithelial
ATCCAGAGCAACAACC-1	Epithelial
TCCGGTTCGTCCGGTC-1	Epithelial
CGCGCATGTTTGATTG-1	Epithelial
TGGCGATCAAGTTATG-1	Epithelial
CCCTTTGACAGGTCTT-1	Epithelial
CAGAGACGGTCACCCA-1	Fibroblasts
TAGCTCGCCTGATAAC-1	Fibroblasts
TTGTGTTTCCCGAAAG-1	Epithelial
TATACACAGACGCCTT-1	Fibroblasts
ACATTAGTTTATATCC-1	Fibroblasts
CCATCGCAGTTAAACT-1	Epithelial
AATTAGCGCTGCAGCG-1	Endothelial
TCCGCTTATCCCATTA-1	Myofibroblast_Mesothelium
GTTTGGGCTTGTGAGC-1	Fibroblasts
CTTGTCAACATTCGAG-1	Fibroblasts
GGACCAACAGGATAAC-1	Muscle
AAGCTAGATCGAGTAA-1	Muscle
TACCGTGCCTCGGACC-1	Fibroblasts
GTAGCCAAACATGGGA-1	Fibroblasts
TGCCAGTACGTGGAGA-1	Endothelial
ATAAGGTGGAGAACAT-1	Fibroblasts
CTTTAATATTGGTCGA-1	Fibroblasts
TGGTTCAACGGGTAAT-1	Fibroblasts
GCTGCTACTGCGTAGC-1	Fibroblasts
CTGCACAACTACATAT-1	Endothelial
CCACCAACTTTACTGT-1	Neural
AACTCTCAGTGTGCTC-1	Fibroblasts
AAACCGTTCGTCCAGG-1	Fibroblasts
CAGCGATTCCCTTCAA-1	Endothelial
GCTAGCTTGAATAGCT-1	Myofibroblast_Mesothelium
TTGCGGCATCAGAAAG-1	Myofibroblast_Mesothelium
AATAGAACAGAGTGGC-1	Myofibroblast_Mesothelium
GCCATCGAGCTGCGTG-1	Epithelial
ACACTGATCAAGGTGT-1	Fibroblasts
ACCAACGCTTATTTAT-1	Epithelial
GACATCGATTTATAAC-1	Epithelial
CAGACACCGATCGCTG-1	Epithelial
CCAAGAAAGTGGGCGA-1	Epithelial
GGTAGACCGTTGGGCG-1	Epithelial
TCGTTAGGAGTCCCTA-1	Epithelial
ACGGCCAACATGGACT-1	Epithelial
GTGAGTGGTACAACGC-1	Epithelial
GAGACTTCGCGACCGA-1	Fibroblasts
GAAGTCAGTTGCACTA-1	Fibroblasts
GTTTGGTAGGGTCAAC-1	Fibroblasts
ACGGCACTTGCTTGGG-1	Myofibroblast_Mesothelium
CCTCTGTACTATTCTA-1	Fibroblasts
CTATTCATGTGTCCCA-1	Fibroblasts
GCCCGATCTGTGGTCG-1	Fibroblasts
TTAGAAGAACATGACT-1	Fibroblasts
AGGATAAAGTCGGGAT-1	Muscle
CGGCAAACATCGTGCG-1	Muscle
CTAGTTACAACCCGGT-1	Fibroblasts
TTCGACAGAGCCCGTG-1	Fibroblasts
AAGCATACTCTCCTGA-1	Fibroblasts
GACGACGATCCGCGTT-1	Fibroblasts
GAGATGGGAGTCGACA-1	Fibroblasts
CAATATTCTTGACCTA-1	Neural
CGTTTGTGTAGAGGGT-1	Fibroblasts
CATAGCGTTGCCCACC-1	Fibroblasts
TGATACATTTAGCCGT-1	Endothelial
TTCCGGCCTTGAGGCT-1	Myofibroblast_Mesothelium
CCTATACCGTCCTGTC-1	Myofibroblast_Mesothelium
TCGTTGCTATCCGGTC-1	Epithelial
TGGCGACTGCTCCAAA-1	Fibroblasts
CAGAGGCGATGCATGA-1	Fibroblasts
TCACAGGAGAATAAGA-1	Fibroblasts
GGGTTAACATTTGAGT-1	Epithelial
GCGGGCGAGCCTTACC-1	Epithelial
TGCCAATGGGTACTCT-1	Epithelial
AGGGACTCTACGCGAC-1	Epithelial
GACGCCGTAAAGGCTA-1	Epithelial
AAAGGCTCTCGCGCCG-1	Epithelial
CTGGCTGGTTGTCAGT-1	Fibroblasts
ACATCCCGGCCATACG-1	Epithelial
CTCTTGTCCCGCTTGG-1	Fibroblasts
TACGCCTCCATTCCGA-1	Myofibroblast_Mesothelium
CGGAGCAATTTAATCG-1	Myofibroblast_Mesothelium
AACTAGGCTTGGGTGT-1	Fibroblasts
GCGTCGCCAGGGTGAT-1	Fibroblasts
GTTGGTCATGCTATCC-1	Muscle
GCTGGCGGCGCATGCT-1	Neural
TGAGCGGAAAGTGTTC-1	Fibroblasts
CTTTCTGTGCGGGCTT-1	Fibroblasts
ATCTAATATCCTACGG-1	Fibroblasts
AACCTTTAAATACGGT-1	Endothelial
ACCCTATGCCATATCG-1	Muscle
GTGGTATAGTCTGCCG-1	Fibroblasts
CCGGTTTGTAATTGTG-1	Fibroblasts
GTCGCCGTTGTGTGTT-1	Fibroblasts
TACTGAACAGATTTAG-1	Fibroblasts
TATTAACCTGACCGCG-1	Fibroblasts
CTGTAGCCATCTCACT-1	Myofibroblast_Mesothelium
TACTATGGTTCCTCAG-1	Endothelial
GAGTCAGACCAGAATC-1	Epithelial
TAAGGCATAACATCAA-1	Fibroblasts
GGTCGGTCGTCCACAG-1	Myofibroblast_Mesothelium
GGGACCCGTATATCTT-1	Epithelial
GAAAGCAGTGCACTTT-1	Epithelial
AGCGCATAATGAATCG-1	Epithelial
GCTGCTAAGTAGTCGA-1	Epithelial
AATAGTCCGTCCCGAC-1	Myofibroblast_Mesothelium
AGCAGCCAGATGAATA-1	Myofibroblast_Mesothelium
CCTCGCGCTGTGCGAT-1	Myofibroblast_Mesothelium
TTGTGTATGCCACCAA-1	Fibroblasts
TGCTCGGCGAAACCCA-1	Fibroblasts
CGATTAAATATCTCCT-1	Fibroblasts
TGCCGTGGATCGTCCT-1	Muscle
GTGGACGCATTTGTCC-1	Neural
ACCCGGAAACTCCCAG-1	Fibroblasts
CCGCATGTGGTACGAT-1	Fibroblasts
ATTCACTGATGTTGGA-1	Fibroblasts
TCCTAAATTGGGAAGC-1	Fibroblasts
GAACAGATTACTAAAT-1	Fibroblasts
CGATTCGCCTGGCTGC-1	Fibroblasts
ACTATTTCCGGGCCCA-1	Neural
TTGTTTCACATCCAGG-1	Fibroblasts
CGCTGTGTGGATGTTG-1	Fibroblasts
TCAACATAGCGCCCTA-1	Fibroblasts
GGCCGTTTGGGTTTCA-1	Fibroblasts
TACTCTTTCGTCTTCA-1	Myofibroblast_Mesothelium
TTCGCGCGCCATACGA-1	Fibroblasts
CGGAAAGAATCAAACG-1	Endothelial
AGGCAGGGAGCGTACT-1	Fibroblasts
CCTTTAAGGGAGCACT-1	Fibroblasts
CGCCCAGCACGCCTAG-1	Fibroblasts
TATCCGCACCGTCGGG-1	Myofibroblast_Mesothelium
ACCCGTGTCATCAGTA-1	Epithelial
CAACTGCTCATCCGAT-1	Myofibroblast_Mesothelium
CCGGAGCGTACTTTCT-1	Myofibroblast_Mesothelium
TACCGTAGGTTAACTA-1	Fibroblasts
TGAGGAGTGCCAGCTT-1	Myofibroblast_Mesothelium
CCAGTCTTGTCATAGA-1	Fibroblasts
GGGCAGAGCAATCGTT-1	Fibroblasts
TACCAAATAGCCCAGA-1	Muscle
TACCTACTCCCAGTAT-1	Muscle
TGTGAGACTAGCCCAA-1	Fibroblasts
ATACCTAACCAAGAAA-1	Fibroblasts
GTCGGGAAGCAGAAAC-1	Fibroblasts
ACGTTCGTTCAGGAAA-1	Fibroblasts
TTAGAATAAGGGTCGG-1	Fibroblasts
TTCTAGAAAGTCTTAT-1	Fibroblasts
CCTTCAGTTAAAGTGA-1	Fibroblasts
TAGCTAGTGATGATGG-1	Myofibroblast_Mesothelium
AGCCCGGTAGCCTGTA-1	Fibroblasts
TACCTCAGTTGTCTGT-1	Myofibroblast_Mesothelium
GACGGGTTGGCCCGTA-1	Fibroblasts
GAAACCTATACAAATG-1	Myofibroblast_Mesothelium
TCCACCTCTAGCCTTT-1	Fibroblasts
AAGACCCAACTGAACA-1	Fibroblasts
CATACACGGTTCCCAC-1	Fibroblasts
ACTACGCGTTAGAATT-1	Fibroblasts
CTTGGCCAAGCTGGGA-1	Muscle
TTACCCTAGGGATTGG-1	Fibroblasts
TTCGCACTGTACGACA-1	Neural
TAGGTGTTCCACAGAT-1	Neural
GAAGCCTGCACATTCC-1	Fibroblasts
GGCTTTCAATAAGGGT-1	Endothelial
TCCAGGGTATATACGA-1	Pericytes
CTCGCCGAATGTAGGG-1	Fibroblasts
TCCTAACCGTCGGGCA-1	Fibroblasts
ACGCAAACTAATAGAT-1	Muscle
AAGTGAGTCGGGTTTA-1	Fibroblasts
TAAAGCGGTATTTCCA-1	Fibroblasts
CTCCTCCAGCTCACAC-1	Fibroblasts
CGGTCCGTCGCAAGCC-1	Fibroblasts
CCTATATTTGTCCTGG-1	Fibroblasts
TCCAATAAAGGCTACC-1	Fibroblasts
AAAGGCTACGGACCAT-1	Fibroblasts
CGTGACCAGTCCTCTG-1	Muscle
GATCTGCTATCTAAGG-1	Muscle
CGAATGACGCATAATG-1	Fibroblasts
GCTCAATGTAATACCG-1	Fibroblasts
CTATGCCCGAATGCAA-1	Fibroblasts
CACAGGGCCGTTGTCA-1	Fibroblasts
TCAATACGCCGTCATG-1	Endothelial
AGCGGACACTTCGTAG-1	Fibroblasts
GAGTAGATACTAGTTG-1	Fibroblasts
TATAGAGTCGCTTGAA-1	Neural
ATGTTGTAGTCTGTTT-1	Fibroblasts
AGTATACACAGCGACA-1	Muscle
TGTGGTTGCTAAAGCT-1	Neural
TGATTCCCGGTTACCT-1	Muscle
CACTGACGATTGTGGA-1	Neural
AACATTGTGACTCGAG-1	Muscle
GTCCAATATTTAGCCT-1	Fibroblasts
GCTCTTTCCGCTAGTG-1	Muscle
GGGTCAGGAGCTAGAT-1	Fibroblasts
AGGTGGTGACCTTCGC-1	Fibroblasts
AGCCAAGCTTTGTGTC-1	Neural
TGTGGCGGGCTTCTGG-1	Fibroblasts
CGAGGGTATCCAGGTG-1	Fibroblasts
CGTTCAGACCCGCGAA-1	Fibroblasts
TGAATGAGTGTTTCCC-1	Fibroblasts
TTCACTTCCTAGAACG-1	Fibroblasts
CGCTTAGTATTGATAC-1	Fibroblasts
AACGCGACCTTGGGCG-1	Fibroblasts
GTGCACCAGCTTCAAC-1	Fibroblasts
TTCTATTAAACGCAGC-1	Pericytes
CATACTTCTTTCTCCG-1	Pericytes
AGCCCGCAACAAGCAG-1	Endothelial
TCGTACCGACGTCAAG-1	Pericytes
