Cell	Annotation
AAACCCAAGATCGGTG-1	Pericytes
AAACCCACAATGGCCC-1	Fibroblasts
AAACCCACACAGCTGC-1	Epithelial
AAACCCACAGAAGTGC-1	Fibroblasts
AAACCCAGTGTCTTCC-1	Pericytes
AAACCCATCTTTGCAT-1	Pericytes
AAACGAAAGACCAGCA-1	Neural
AAACGAATCGATACGT-1	Fibroblasts
AAACGCTAGGTTCTTG-1	Neural
AAACGCTCACAAGCTT-1	Myofibroblast_Mesothelium
AAACGCTCACTTGGGC-1	Myofibroblast_Mesothelium
AAACGCTCATGTTTGG-1	Fibroblasts
AAACGCTGTAGGAGGG-1	Pericytes
AAACGCTGTCTCCCTA-1	Endothelial
AAACGCTGTTCACCGG-1	Epithelial
AAACGCTTCCTTGGAA-1	Endothelial
AAAGAACAGAGAGGGC-1	Epithelial
AAAGAACAGCGTGCTC-1	Fibroblasts
AAAGAACCATCACGGC-1	Fibroblasts
AAAGAACCATCGGAGA-1	Fibroblasts
AAAGAACGTCGAGTGA-1	Epithelial
AAAGAACGTCGTACAT-1	Endothelial
AAAGGATAGTATTGCC-1	Muscle
AAAGGATAGTTCCAGT-1	Fibroblasts
AAAGGATCAATTGGTC-1	Epithelial
AAAGGATCACTACCCT-1	Fibroblasts
AAAGGATGTCATCCGG-1	Epithelial
AAAGGATGTTCTCACC-1	Fibroblasts
AAAGGATTCAAGCTTG-1	Epithelial
AAAGGATTCAAGTCGT-1	Epithelial
AAAGGATTCTCATTTG-1	Muscle
AAAGGGCGTGAGCCAA-1	Endothelial
AAAGGGCGTGCGGATA-1	Fibroblasts
AAAGGGCTCACTACGA-1	Epithelial
AAAGGTAAGAGAGGGC-1	Neural
AAAGGTAAGCCTTTGA-1	Fibroblasts
AAAGGTACATTATGCG-1	Fibroblasts
AAAGGTATCAGATGCT-1	Immune
AAAGTCCGTCAATGGG-1	Pericytes
AAAGTCCGTGTCCTAA-1	Immune
AAAGTCCGTGTCTCCT-1	Epithelial
AAAGTCCTCCACGTGG-1	Pericytes
AAAGTGAAGCGGACAT-1	Muscle
AAAGTGACAAGCAGGT-1	Fibroblasts
AAAGTGACAGGCATTT-1	Myofibroblast_Mesothelium
AAAGTGACATGGGATG-1	Endothelial
AAAGTGATCTTCTGGC-1	Fibroblasts
AAATGGAAGACCTTTG-1	Epithelial
AAATGGAAGTTGAAGT-1	Fibroblasts
AAATGGATCATCTATC-1	Fibroblasts
AAATGGATCCGTGACG-1	Fibroblasts
AACAAAGCATGGAAGC-1	Epithelial
AACAAAGGTGTTAACC-1	Muscle
AACAAAGGTGTTAGCT-1	Myofibroblast_Mesothelium
AACAAAGTCTCGTGGG-1	Epithelial
AACAACCAGTATGAGT-1	Neural
AACAACCCACGTCGGT-1	Fibroblasts
AACAACCTCCAAAGGG-1	Epithelial
AACAACCTCTTCTCAA-1	Muscle
AACAACCTCTTGGTGA-1	Neural
AACAAGAAGACAGCTG-1	Fibroblasts
AACAAGAAGAGCAAGA-1	Epithelial
AACAAGAAGCCGAATG-1	Fibroblasts
AACAAGAAGGCAATGC-1	Fibroblasts
AACAAGACACCCAAGC-1	Fibroblasts
AACAAGAGTGTCCACG-1	Endothelial
AACAAGATCGTCACCT-1	Epithelial
AACACACGTTGGGTTT-1	Fibroblasts
AACACACTCTTGTGCC-1	Myofibroblast_Mesothelium
AACAGGGCAAGAGTTA-1	Epithelial
AACAGGGCAGCTACAT-1	Myofibroblast_Mesothelium
AACAGGGGTCGTCAGC-1	Epithelial
AACCAACAGATGCTTC-1	Neural
AACCAACCAAGCCCAC-1	Epithelial
AACCAACGTGCCTAAT-1	Pericytes
AACCAACTCCCGAGTG-1	Fibroblasts
AACCAACTCTAGACAC-1	Endothelial
AACCAACTCTTCACAT-1	Pericytes
AACCACAAGCTAGAAT-1	Epithelial
AACCACAAGGCACTAG-1	Fibroblasts
AACCACACACCGGTCA-1	Neural
AACCACACACTCCTGT-1	Neural
AACCACATCGACGCTG-1	Fibroblasts
AACCACATCTATTTCG-1	Fibroblasts
AACCATGAGCCTTTCC-1	Myofibroblast_Mesothelium
AACCATGCACCAACAT-1	Myofibroblast_Mesothelium
AACCATGCACCATTCC-1	Endothelial
AACCATGCACCGGAAA-1	Neural
AACCATGCATTGGATC-1	Muscle
AACCATGGTTCTCCTG-1	Myofibroblast_Mesothelium
AACCATGTCGTGGGTC-1	Epithelial
AACCCAAAGCCATGCC-1	Muscle
AACCCAAAGGTTCTTG-1	Fibroblasts
AACCCAACAAGTGGTG-1	Myofibroblast_Mesothelium
AACCCAACAGAACGCA-1	Endothelial
AACCCAATCAAATGAG-1	Fibroblasts
AACCTGAGTTCTTGTT-1	Pericytes
AACCTGATCCAACACA-1	Myofibroblast_Mesothelium
AACCTTTAGCTCATAC-1	Epithelial
AACCTTTCACTCGATA-1	Epithelial
AACCTTTCAGATCCTA-1	Myofibroblast_Mesothelium
AACCTTTCAGGTACGA-1	Endothelial
AACCTTTGTACCGGAA-1	Fibroblasts
AACCTTTTCAGGACAG-1	Endothelial
AACCTTTTCGTGCAGC-1	Muscle
AACGAAAGTAATTGGA-1	Epithelial
AACGAAATCGACATAC-1	Neural
AACGGGAAGTGTACCT-1	Fibroblasts
AACGGGAGTGTTCCAA-1	Fibroblasts
AACGGGATCATTACTC-1	Epithelial
AACGGGATCGCCGAGT-1	Fibroblasts
AACGTCAAGAATTTGG-1	Epithelial
AACGTCACACAGAGCA-1	Endothelial
AACGTCACAGTTAAAG-1	Fibroblasts
AACGTCAGTATCGTGT-1	Myofibroblast_Mesothelium
AACGTCAGTCCAAATC-1	Epithelial
AACGTCATCGATACTG-1	Pericytes
AACTTCTAGACTAAGT-1	Neural
AACTTCTCAGCGTATT-1	Myofibroblast_Mesothelium
AACTTCTTCCCAAGCG-1	Fibroblasts
AAGAACAAGATCACCT-1	Fibroblasts
AAGAACAAGCATTGTC-1	Endothelial
AAGAACAAGCTATCTG-1	Fibroblasts
AAGAACAAGGAACTAT-1	Endothelial
AAGAACAAGGGTCAAC-1	Myofibroblast_Mesothelium
AAGAACAGTATCTCGA-1	Fibroblasts
AAGAACAGTCGTGATT-1	Epithelial
AAGAACATCATGCCAA-1	Muscle
AAGAACATCCGACATA-1	Fibroblasts
AAGAACATCGCCAATA-1	Neural
AAGACAACACCTCAGG-1	Muscle
AAGACAACACGGCACT-1	Pericytes
AAGACAACAGAAATCA-1	Myofibroblast_Mesothelium
AAGACAAGTTGCGGCT-1	Epithelial
AAGACAAGTTGTGTAC-1	Fibroblasts
AAGACTCAGAGAAGGT-1	Fibroblasts
AAGACTCAGCTAAATG-1	Pericytes
AAGACTCCACCGTACG-1	Fibroblasts
AAGACTCCACGTATAC-1	Epithelial
AAGACTCGTTAAGAAC-1	Myofibroblast_Mesothelium
AAGACTCGTTCCGCAG-1	Endothelial
AAGACTCTCATCACCC-1	Immune
AAGACTCTCGAGATGG-1	Pericytes
AAGATAGGTACTAGCT-1	Epithelial
AAGATAGGTATAGCTC-1	Fibroblasts
AAGATAGGTCACGCTG-1	Epithelial
AAGATAGTCCAGCAAT-1	Epithelial
AAGATAGTCCTAGCCT-1	Immune
AAGCATCAGGGCATGT-1	Fibroblasts
AAGCATCGTCCTCATC-1	Epithelial
AAGCATCTCTCAGAAC-1	Fibroblasts
AAGCATCTCTCCGAAA-1	Epithelial
AAGCATCTCTGCATAG-1	Epithelial
AAGCCATAGAATACAC-1	Fibroblasts
AAGCCATCAGCGACCT-1	Endothelial
AAGCCATGTAAGTAGT-1	Fibroblasts
AAGCCATGTGTGACCC-1	Epithelial
AAGCCATTCCAGCTCT-1	Muscle
AAGCGAGAGAGCATAT-1	Fibroblasts
AAGCGAGCACGCTGAC-1	Fibroblasts
AAGCGAGGTAACAGGC-1	Neural
AAGCGAGTCCACAAGT-1	Myofibroblast_Mesothelium
AAGCGTTGTCACGTGC-1	Endothelial
AAGCGTTTCCGATCGG-1	Endothelial
AAGGAATAGGATAATC-1	Fibroblasts
AAGGAATAGGGCAGGA-1	Epithelial
AAGGAATCAATGGGTG-1	Epithelial
AAGGAATCATGACTGT-1	Pericytes
AAGGAATGTACAGCGA-1	Myofibroblast_Mesothelium
AAGGTAAGTCTTCATT-1	Pericytes
AAGGTAATCTATCCAT-1	Fibroblasts
AAGTACCAGCAGTAAT-1	Endothelial
AAGTACCCATTGGCAT-1	Epithelial
AAGTACCGTACGATCT-1	Myofibroblast_Mesothelium
AAGTACCGTCTGTCCT-1	Fibroblasts
AAGTACCTCCTTCTGG-1	Endothelial
AAGTACCTCTAGGCCG-1	Fibroblasts
AAGTCGTAGTGGAAAG-1	Epithelial
AAGTCGTCACTCAAGT-1	Fibroblasts
AAGTCGTCACTCGATA-1	Epithelial
AAGTCGTCAGCTGGTC-1	Endothelial
AAGTCGTCAGTAACAA-1	Fibroblasts
AAGTCGTCATTCATCT-1	Epithelial
AAGTCGTCATTGAGCT-1	Epithelial
AAGTCGTCATTGCTTT-1	Fibroblasts
AAGTCGTGTACTAAGA-1	Fibroblasts
AAGTCGTTCAACTACG-1	Myofibroblast_Mesothelium
AAGTCGTTCAATGCAC-1	Epithelial
AAGTGAACAATAGAGT-1	Immune
AAGTGAACACGATTCA-1	Pericytes
AAGTGAACAGATCCAT-1	Fibroblasts
AAGTGAAGTTAATGAG-1	Fibroblasts
AAGTGAATCATGGTAC-1	Fibroblasts
AAGTGAATCCTCCACA-1	Fibroblasts
AAGTTCGAGAGTGAAG-1	Epithelial
AAGTTCGAGTCCCGAC-1	Endothelial
AAGTTCGCACAAGCCC-1	Epithelial
AAGTTCGCAGCATTGT-1	Endothelial
AAGTTCGGTGCTCTTC-1	Myofibroblast_Mesothelium
AAGTTCGGTTAGGAGC-1	Pericytes
AAGTTCGGTTCGGTCG-1	Epithelial
AAGTTCGTCGTAGCCG-1	Epithelial
AATAGAGAGGCATCTT-1	Fibroblasts
AATAGAGAGTTCATGC-1	Epithelial
AATAGAGCAAGCGAAC-1	Fibroblasts
AATAGAGTCTATTCGT-1	Pericytes
AATCACGCATATGCGT-1	Fibroblasts
AATCACGTCCCTATTA-1	Endothelial
AATCGACAGCCAACCC-1	Fibroblasts
AATCGACAGTTGCCTA-1	Fibroblasts
AATCGACCAGGAATAT-1	Fibroblasts
AATCGACTCCACTGGG-1	Pericytes
AATCGACTCGACGACC-1	Fibroblasts
AATCGTGAGCAAGCCA-1	Epithelial
AATCGTGCACGAAGAC-1	Fibroblasts
AATCGTGGTGGACCAA-1	Epithelial
AATCGTGTCGGAATTC-1	Pericytes
AATGAAGAGCTCTGTA-1	Fibroblasts
AATGAAGCAGCTACTA-1	Fibroblasts
AATGAAGGTCACTACA-1	Epithelial
AATGAAGGTCTTCCGT-1	Epithelial
AATGAAGGTCTTGCTC-1	Epithelial
AATGAAGGTTAGCTAC-1	Epithelial
AATGAAGTCACGGACC-1	Fibroblasts
AATGACCAGCGGCTCT-1	Myofibroblast_Mesothelium
AATGACCAGTCACACT-1	Fibroblasts
AATGACCGTACAAAGT-1	Endothelial
AATGACCGTAGCTCGC-1	Epithelial
AATGACCGTGCAACAG-1	Epithelial
AATGACCTCAACCCGG-1	Pericytes
AATGACCTCCATATGG-1	Fibroblasts
AATGACCTCCTACGGG-1	Epithelial
AATGACCTCTTGGGCG-1	Myofibroblast_Mesothelium
AATGCCACAGGCGTTC-1	Pericytes
AATGCCAGTAATTAGG-1	Epithelial
AATGCCAGTCGGTGAA-1	Endothelial
AATGCCAGTGCAAGAC-1	Fibroblasts
AATGCCAGTGCTTATG-1	Fibroblasts
AATGCCATCCGTGACG-1	Epithelial
AATGGAAAGCACTGGA-1	Epithelial
AATGGAAAGGACATCG-1	Endothelial
AATGGAATCGTAGGGA-1	Epithelial
AATGGAATCTTCTAAC-1	Endothelial
AATGGCTAGTCTAACC-1	Fibroblasts
AATGGCTCACGCCAGT-1	Myofibroblast_Mesothelium
AATGGCTCAGTGCGCT-1	Epithelial
AATGGCTTCGTCACCT-1	Epithelial
AATTCCTAGCGCCTTG-1	Epithelial
AATTCCTCACCTGTCT-1	Fibroblasts
AATTCCTCAGCGACAA-1	Fibroblasts
AATTCCTCAGGACAGT-1	Pericytes
AATTCCTGTAGCGCCT-1	Neural
AATTCCTGTGAACGGT-1	Endothelial
AATTCCTGTGATTAGA-1	Epithelial
AATTCCTTCGATACGT-1	Immune
AATTCCTTCTTGTTAC-1	Fibroblasts
AATTTCCAGAACGTGC-1	Pericytes
AATTTCCAGTCCGCCA-1	Epithelial
AATTTCCCAACGTTAC-1	Myofibroblast_Mesothelium
AATTTCCCAGACCGCT-1	Muscle
AATTTCCTCCGTGGGT-1	Endothelial
ACAAAGAAGAAGTATC-1	Endothelial
ACAAAGAAGTCGGGAT-1	Fibroblasts
ACAAAGACAAGCTACT-1	Fibroblasts
ACAAAGAGTCCAGGTC-1	Fibroblasts
ACAAAGATCGGTAACT-1	Endothelial
ACAACCAGTAGATTGA-1	Pericytes
ACAACCAGTCATGGCC-1	Epithelial
ACAACCAGTCCGGTCA-1	Fibroblasts
ACAAGCTAGACTGTTC-1	Epithelial
ACAAGCTAGCCTTCTC-1	Endothelial
ACAAGCTCACCAGTAT-1	Fibroblasts
ACAAGCTCACGCTGCA-1	Endothelial
ACAAGCTGTGTATCCA-1	Epithelial
ACAAGCTTCCGTGGGT-1	Epithelial
ACAAGCTTCGGACTTA-1	Myofibroblast_Mesothelium
ACAAGCTTCGGTAACT-1	Myofibroblast_Mesothelium
ACAAGCTTCTCCCATG-1	Myofibroblast_Mesothelium
ACAAGCTTCTGTCCCA-1	Myofibroblast_Mesothelium
ACACAGTAGCGACATG-1	Myofibroblast_Mesothelium
ACACAGTTCAGACATC-1	Pericytes
ACACCAAAGGGACCAT-1	Endothelial
ACACCAACATCCTTGC-1	Myofibroblast_Mesothelium
ACACCAAGTGGCACTC-1	Epithelial
ACACCAATCCAACCGG-1	Pericytes
ACACCAATCTGCATAG-1	Endothelial
ACACCAATCTGTGTGA-1	Endothelial
ACACGCGAGTAGGATT-1	Epithelial
ACACGCGCAAGCCTGC-1	Fibroblasts
ACACGCGCATACAGGG-1	Epithelial
ACACGCGGTGTTAGCT-1	Epithelial
ACACTGAAGACGGAAA-1	Epithelial
ACACTGAAGCATGAAT-1	Epithelial
ACACTGACACGTTCGG-1	Myofibroblast_Mesothelium
ACACTGACAGCGGTCT-1	Muscle
ACACTGACATCCGGTG-1	Epithelial
ACACTGATCAAATGCC-1	Fibroblasts
ACACTGATCTTCGATT-1	Myofibroblast_Mesothelium
ACAGAAAAGACCAACG-1	Fibroblasts
ACAGAAAAGGCACAAC-1	Fibroblasts
ACAGAAACACAACATC-1	Immune
ACAGAAACAGCTCATA-1	Fibroblasts
ACAGAAACAGTTCTAG-1	Pericytes
ACAGCCGAGATCGCTT-1	Fibroblasts
ACAGCCGAGATGTTAG-1	Endothelial
ACAGCCGCAGCTACCG-1	Fibroblasts
ACAGCCGCAGTAGTTC-1	Neural
ACAGCCGGTAGAGATT-1	Fibroblasts
ACAGCCGGTGAGTAAT-1	Epithelial
ACAGCCGGTTCCTTGC-1	Myofibroblast_Mesothelium
ACAGGGAAGTAAATGC-1	Myofibroblast_Mesothelium
ACAGGGAAGTAAGACT-1	Epithelial
ACAGGGACAAGACCTT-1	Epithelial
ACAGGGACAATTTCGG-1	Epithelial
ACAGGGATCGCATAGT-1	Myofibroblast_Mesothelium
ACAGGGATCTGCGGAC-1	Myofibroblast_Mesothelium
ACATCCCAGCCAAGGT-1	Fibroblasts
ACATCCCAGCGTCTCG-1	Fibroblasts
ACATCCCAGCTAGAAT-1	Epithelial
ACATCCCCAATGCAAA-1	Endothelial
ACATCCCCACTACCGG-1	Epithelial
ACATCCCCACTTCCTG-1	Endothelial
ACATCCCGTAGGTAGC-1	Muscle
ACATCCCGTCATAAAG-1	Myofibroblast_Mesothelium
ACATCCCTCACTGGTA-1	Epithelial
ACATCGATCCTTTGAT-1	Fibroblasts
ACATGCACACACAGAG-1	Epithelial
ACATGCAGTTATGTCG-1	Epithelial
ACATGCATCAATCAGC-1	Neural
ACATGCATCAGACCTA-1	Myofibroblast_Mesothelium
ACATGCATCTCACGAA-1	Epithelial
ACATGCATCTGGACTA-1	Pericytes
ACATTTCAGCTTTCCC-1	Epithelial
ACATTTCAGGGAGGTG-1	Epithelial
ACATTTCAGTGCTACT-1	Endothelial
ACATTTCCAAGCTGCC-1	Neural
ACATTTCCACTAGAGG-1	Endothelial
ACATTTCCATCAGTGT-1	Fibroblasts
ACATTTCGTGAGACCA-1	Epithelial
ACCAAACCACTCCGGA-1	Fibroblasts
ACCAAACCAGATCACT-1	Endothelial
ACCAAACCATCTTAGG-1	Epithelial
ACCAAACGTATCACCA-1	Epithelial
ACCAAACGTATGTCTG-1	Endothelial
ACCAAACTCACCCATC-1	Myofibroblast_Mesothelium
ACCAAACTCTCAGGCG-1	Pericytes
ACCAACAAGCTACAAA-1	Fibroblasts
ACCAACAAGCTGTACT-1	Muscle
ACCAACAAGGGAGTTC-1	Myofibroblast_Mesothelium
ACCAACACATGGCGCT-1	Pericytes
ACCAACATCTATGCCC-1	Fibroblasts
ACCACAAGTGGTATGG-1	Fibroblasts
ACCACAAGTTCACGAT-1	Fibroblasts
ACCACAAGTTGATGTC-1	Myofibroblast_Mesothelium
ACCATTTTCTAAGGAA-1	Fibroblasts
ACCATTTTCTAGTGAC-1	Epithelial
ACCCAAAAGAGTTGTA-1	Fibroblasts
ACCCAAACAGACCAGA-1	Pericytes
ACCCTCAAGATTCGAA-1	Epithelial
ACCCTCACACAGCCAC-1	Myofibroblast_Mesothelium
ACCCTCACAGCTGGTC-1	Epithelial
ACCCTCACAGTCAGAG-1	Endothelial
ACCCTCACAGTCTTCC-1	Immune
ACCCTCACAGTTTCGA-1	Epithelial
ACCCTCAGTGTGGTCC-1	Fibroblasts
ACCCTCATCGCAATTG-1	Pericytes
ACCCTTGAGAAGGCTC-1	Neural
ACCCTTGAGGACCCAA-1	Fibroblasts
ACCCTTGCACGGCCAT-1	Epithelial
ACCCTTGCATTGACCA-1	Fibroblasts
ACCCTTGGTGGCTCTG-1	Fibroblasts
ACCCTTGTCATCGGGC-1	Epithelial
ACCGTTCAGTCTGGTT-1	Epithelial
ACCGTTCCACGGGCTT-1	Endothelial
ACCGTTCGTTGTTGAC-1	Fibroblasts
ACCTACCAGCACTGGA-1	Immune
ACCTACCAGTCTAACC-1	Fibroblasts
ACCTACCGTCCAAAGG-1	Pericytes
ACCTACCGTTCGGCCA-1	Endothelial
ACCTACCTCCTACAAG-1	Fibroblasts
ACCTACCTCGACCATA-1	Fibroblasts
ACCTGAAAGCCTAACT-1	Epithelial
ACCTGAACAAGGTCGA-1	Fibroblasts
ACCTGAACACGCTATA-1	Muscle
ACCTGAACAGAATTCC-1	Fibroblasts
ACCTGAAGTACGATCT-1	Fibroblasts
ACCTGAAGTACTGGGA-1	Epithelial
ACCTGAAGTAGTCGTT-1	Muscle
ACCTGAAGTGGCCCAT-1	Myofibroblast_Mesothelium
ACCTGAATCAACACCA-1	Muscle
ACCTGAATCTATCCAT-1	Epithelial
ACCTGTCAGCAGTAAT-1	Epithelial
ACCTGTCAGTAAGAGG-1	Epithelial
ACCTGTCCATGGATCT-1	Pericytes
ACCTGTCGTCTTGCGG-1	Epithelial
ACCTGTCGTTTGTTGG-1	Pericytes
ACCTGTCTCATTTGCT-1	Fibroblasts
ACGATCAAGAAACACT-1	Fibroblasts
ACGATGTCATGAAGCG-1	Fibroblasts
ACGATGTTCGCTGACG-1	Endothelial
ACGATGTTCTCGCCTA-1	Myofibroblast_Mesothelium
ACGCACGAGTGCCCGT-1	Epithelial
ACGCACGGTAGGTTTC-1	Fibroblasts
ACGCACGTCAAGAAAC-1	Immune
ACGCACGTCCGCGAGT-1	Fibroblasts
ACGCACGTCTGGTGGC-1	Endothelial
ACGGAAGAGACGCCAA-1	Fibroblasts
ACGGAAGCAACCACGC-1	Fibroblasts
ACGGAAGCAGATCCAT-1	Fibroblasts
ACGGAAGCAGGCTCTG-1	Epithelial
ACGGAAGGTTAGAAAC-1	Epithelial
ACGGGTCAGAATTCAG-1	Pericytes
ACGGGTCAGGAGGTTC-1	Fibroblasts
ACGGGTCCAAAGGCGT-1	Fibroblasts
ACGGGTCCATACAGGG-1	Fibroblasts
ACGGGTCGTCCTATAG-1	Endothelial
ACGGGTCTCAAGCCAT-1	Fibroblasts
ACGGGTCTCCAAGCTA-1	Myofibroblast_Mesothelium
ACGGTCGAGGTAGCCA-1	Myofibroblast_Mesothelium
ACGGTCGCAATCAGCT-1	Epithelial
ACGGTCGCAGAAGTGC-1	Fibroblasts
ACGGTCGCAGGTTCAT-1	Fibroblasts
ACGGTCGGTATGAAGT-1	Epithelial
ACGGTCGGTTCCAGGC-1	Endothelial
ACGGTTAAGACCATGG-1	Fibroblasts
ACGGTTAAGATCGCCC-1	Endothelial
ACGGTTACACTGAGGA-1	Endothelial
ACGGTTACATACCATG-1	Myofibroblast_Mesothelium
ACGGTTAGTAAGCTCT-1	Epithelial
ACGTAACAGAACAAGG-1	Myofibroblast_Mesothelium
ACGTAACCAATTGAGA-1	Endothelial
ACGTACAAGCCACCGT-1	Fibroblasts
ACGTACAAGGTCGAGT-1	Muscle
ACGTACACAAATGCTC-1	Epithelial
ACGTACACACGGCCAT-1	Endothelial
ACGTACACAGCGGTCT-1	Neural
ACGTACACATCGCTAA-1	Fibroblasts
ACGTACAGTCGTAATC-1	Pericytes
ACGTACAGTGACCGTC-1	Myofibroblast_Mesothelium
ACGTACAGTGTGTGTT-1	Neural
ACGTAGTAGAACTCCT-1	Epithelial
ACGTAGTAGCCGGATA-1	Epithelial
ACGTAGTCAGACCATT-1	Myofibroblast_Mesothelium
ACGTAGTGTAGGCAGT-1	Fibroblasts
ACGTAGTGTCAGCGTC-1	Muscle
ACGTAGTTCAGAGCGA-1	Endothelial
ACGTAGTTCATCTACT-1	Immune
ACGTAGTTCATGCCCT-1	Endothelial
ACGTAGTTCCTCACGT-1	Fibroblasts
ACGTAGTTCTATCGGA-1	Fibroblasts
ACGTCCTAGCGCTGAA-1	Endothelial
ACGTCCTAGGTTGCCC-1	Endothelial
ACGTCCTAGTTCACTG-1	Pericytes
ACGTCCTCATGAGAAT-1	Pericytes
ACGTCCTGTAACTGCT-1	Fibroblasts
ACGTCCTGTCTACGAT-1	Epithelial
ACGTCCTGTTAAAGTG-1	Myofibroblast_Mesothelium
ACGTCCTTCAAACTGC-1	Muscle
ACGTCCTTCCAGTTCC-1	Fibroblasts
ACGTCCTTCTAAGCGT-1	Fibroblasts
ACGTTCCAGCCAAGTG-1	Endothelial
ACGTTCCAGGTCCCTG-1	Myofibroblast_Mesothelium
ACGTTCCGTCCAGAAG-1	Endothelial
ACGTTCCGTCTAGTGT-1	Epithelial
ACGTTCCTCGCTACGG-1	Neural
ACTACGAAGAAACCAT-1	Myofibroblast_Mesothelium
ACTACGAAGCCAAGCA-1	Fibroblasts
ACTACGACAACAACAA-1	Myofibroblast_Mesothelium
ACTACGACAATTTCGG-1	Myofibroblast_Mesothelium
ACTACGACAGACTCTA-1	Epithelial
ACTACGAGTACGATGG-1	Fibroblasts
ACTACGAGTAGGAGTC-1	Fibroblasts
ACTACGAGTCACAGAG-1	Fibroblasts
ACTACGAGTCATGACT-1	Myofibroblast_Mesothelium
ACTACGAGTCCCGCAA-1	Epithelial
ACTACGATCAGGTAAA-1	Fibroblasts
ACTACGATCGCGTTTC-1	Myofibroblast_Mesothelium
ACTATCTAGAGGTCAC-1	Epithelial
ACTATCTAGTGCTCAT-1	Fibroblasts
ACTATCTCAGACAAGC-1	Epithelial
ACTATCTGTACTTGTG-1	Epithelial
ACTATCTGTGAATTGA-1	Fibroblasts
ACTATCTTCCCGAATA-1	Fibroblasts
ACTATCTTCGTGGGTC-1	Fibroblasts
ACTATGGAGCTACGTT-1	Fibroblasts
ACTATGGAGGTCCCTG-1	Myofibroblast_Mesothelium
ACTATGGCAAGATCCT-1	Immune
ACTATTCAGAAACTGT-1	Muscle
ACTATTCAGGTGCATG-1	Fibroblasts
ACTATTCCAAGCGCAA-1	Endothelial
ACTATTCCACAGAAGC-1	Fibroblasts
ACTATTCCACGAGAAC-1	Epithelial
ACTATTCGTCGCGTCA-1	Myofibroblast_Mesothelium
ACTATTCGTTTGGGAG-1	Epithelial
ACTCCCAAGTAGCATA-1	Muscle
ACTCCCAGTGGTCTGC-1	Pericytes
ACTCCCAGTTACGTAC-1	Myofibroblast_Mesothelium
ACTCCCATCTAAGGAA-1	Myofibroblast_Mesothelium
ACTCCCATCTCAATCT-1	Epithelial
ACTCCCATCTCACTCG-1	Pericytes
ACTCTCGAGCGATTCT-1	Endothelial
ACTCTCGCATCGAAGG-1	Epithelial
ACTCTCGTCCTATTGT-1	Epithelial
ACTCTCGTCGAAGAAT-1	Muscle
ACTGATGAGCAGCGAT-1	Endothelial
ACTGATGCAAATTGGA-1	Epithelial
ACTGATGGTCACGCTG-1	Epithelial
ACTGATGGTGAGATTA-1	Myofibroblast_Mesothelium
ACTGATGGTGGAATGC-1	Endothelial
ACTGATGTCCTAGCGG-1	Epithelial
ACTGATGTCTGCCTCA-1	Myofibroblast_Mesothelium
ACTGCAACAACACGAG-1	Epithelial
ACTGCAACACCCATAA-1	Fibroblasts
ACTGCAACACGCAGTC-1	Fibroblasts
ACTGCAACAGACGCTC-1	Fibroblasts
ACTGCAACATAAGCGG-1	Pericytes
ACTGCAACATAATGCC-1	Myofibroblast_Mesothelium
ACTGCAAGTCGACGCT-1	Epithelial
ACTGCAATCAAAGGAT-1	Myofibroblast_Mesothelium
ACTGCAATCGGCCTTT-1	Epithelial
ACTGTCCCAAGTATCC-1	Fibroblasts
ACTGTCCCAGCTGTTA-1	Fibroblasts
ACTGTGAAGAATAGTC-1	Fibroblasts
ACTGTGAAGTACCGGA-1	Neural
ACTTAGGAGAGTATAC-1	Epithelial
ACTTAGGAGTGGTGAC-1	Myofibroblast_Mesothelium
ACTTAGGCATCAGTCA-1	Pericytes
ACTTAGGGTACGATTC-1	Immune
ACTTAGGTCATTGCCC-1	Epithelial
ACTTAGGTCTCAACCC-1	Endothelial
ACTTATCAGCATTTCG-1	Neural
ACTTATCAGCGACTTT-1	Fibroblasts
ACTTATCAGGTTCTTG-1	Immune
ACTTATCAGTGCACAG-1	Myofibroblast_Mesothelium
ACTTATCCAAATAAGC-1	Fibroblasts
ACTTATCGTGTCCGTG-1	Myofibroblast_Mesothelium
ACTTATCTCAAGGAGC-1	Myofibroblast_Mesothelium
ACTTCCGAGAAGCTGC-1	Endothelial
ACTTCCGAGGTGTGAC-1	Fibroblasts
ACTTCCGGTACAAGCG-1	Epithelial
ACTTCCGGTTCAAACC-1	Endothelial
ACTTCGCAGCCTCTGG-1	Endothelial
ACTTCGCAGGGAGGTG-1	Neural
ACTTCGCAGGTGATAT-1	Neural
ACTTCGCCAAGCCCAC-1	Fibroblasts
ACTTCGCCAGCGAACA-1	Muscle
ACTTCGCCAGCTACCG-1	Fibroblasts
ACTTCGCCAGGTACGA-1	Epithelial
ACTTCGCGTCCATACA-1	Myofibroblast_Mesothelium
ACTTCGCGTCCTGAAT-1	Muscle
ACTTCGCTCACGGGCT-1	Fibroblasts
ACTTCGCTCCTTATAC-1	Fibroblasts
ACTTCGCTCGCCGATG-1	Epithelial
ACTTCGCTCTCGAACA-1	Fibroblasts
ACTTTCACACCGTGAC-1	Myofibroblast_Mesothelium
ACTTTCACACCTGCGA-1	Epithelial
ACTTTCACAGGGTCTC-1	Fibroblasts
ACTTTCACATTGACCA-1	Pericytes
ACTTTGTAGGATATAC-1	Immune
ACTTTGTGTACTGTTG-1	Epithelial
ACTTTGTGTGAATGTA-1	Pericytes
ACTTTGTGTTACACTG-1	Epithelial
ACTTTGTTCGAGCCTG-1	Pericytes
ACTTTGTTCGTGGGTC-1	Endothelial
AGAAATGAGCCGCACT-1	Epithelial
AGAAATGCATTGACAC-1	Myofibroblast_Mesothelium
AGAAATGTCACAGTGT-1	Fibroblasts
AGAACAAAGGGCTTCC-1	Fibroblasts
AGAACAAGTATGTGTC-1	Epithelial
AGAACAATCATTGCTT-1	Pericytes
AGAACAATCTGATGGT-1	Myofibroblast_Mesothelium
AGAACCTAGTAACGTA-1	Endothelial
AGAACCTCAAGAGATT-1	Muscle
AGAACCTCAAGCGAGT-1	Pericytes
AGAACCTGTACGTGTT-1	Fibroblasts
AGAACCTGTGTTACAC-1	Epithelial
AGAACCTTCGAGGCAA-1	Fibroblasts
AGAACCTTCTCGTCAC-1	Fibroblasts
AGAAGCGGTACGATGG-1	Fibroblasts
AGAAGCGTCGAGTCCG-1	Epithelial
AGAAGCGTCTTCTCAA-1	Epithelial
AGAAGTAAGATCCCAT-1	Epithelial
AGAAGTACATCTTTCA-1	Endothelial
AGAAGTAGTATTGAGA-1	Fibroblasts
AGAAGTAGTGGCTTAT-1	Epithelial
AGACAAAAGTTACGTC-1	Immune
AGACAAACAAAGACGC-1	Fibroblasts
AGACAAAGTCACTAGT-1	Epithelial
AGACAAAGTCCATACA-1	Epithelial
AGACAAAGTCGCACGT-1	Immune
AGACACTAGCAGATAT-1	Epithelial
AGACACTAGCCTAGGA-1	Fibroblasts
AGACACTCATCAGCGC-1	Neural
AGACACTGTAAGAACT-1	Muscle
AGACACTGTCCCAAAT-1	Epithelial
AGACACTTCACCCTTG-1	Fibroblasts
AGACACTTCGGAACTT-1	Myofibroblast_Mesothelium
AGACAGGAGATGCCGA-1	Endothelial
AGACAGGAGTCAGCGA-1	Neural
AGACAGGCAATCCTTT-1	Pericytes
AGACAGGCACCGTGGT-1	Epithelial
AGACAGGCACCTCTGT-1	Fibroblasts
AGACAGGGTTCCTAAG-1	Fibroblasts
AGACAGGTCGTTGCCT-1	Epithelial
AGACAGGTCTAAGCCA-1	Fibroblasts
AGACAGGTCTGGACCG-1	Epithelial
AGACAGGTCTGTACAG-1	Neural
AGACCATAGATGCCGA-1	Myofibroblast_Mesothelium
AGACCATAGGCTCCCA-1	Neural
AGACCATAGGGCAGAG-1	Fibroblasts
AGACCATAGTCACGAG-1	Myofibroblast_Mesothelium
AGACCATCAGTTCCAA-1	Endothelial
AGACCATGTCGAGTTT-1	Epithelial
AGACCATGTGTGTTTG-1	Epithelial
AGACCATGTTGGTACT-1	Fibroblasts
AGACCATTCGTCGATA-1	Fibroblasts
AGACCCGCAGTGCGCT-1	Epithelial
AGACCCGGTGTACAGG-1	Fibroblasts
AGACCCGTCGACATAC-1	Muscle
AGACTCAAGGCTCCCA-1	Pericytes
AGACTCACACGTGAGA-1	Immune
AGACTCAGTACCTGTA-1	Neural
AGACTCAGTCGAGATG-1	Immune
AGACTCAGTCTTCATT-1	Myofibroblast_Mesothelium
AGACTCAGTTCCTACC-1	Epithelial
AGACTCATCGCCTCTA-1	Myofibroblast_Mesothelium
AGAGAATAGCAGATAT-1	Myofibroblast_Mesothelium
AGAGAATAGGCAGCTA-1	Myofibroblast_Mesothelium
AGAGAGCAGACAGCGT-1	Myofibroblast_Mesothelium
AGAGAGCCACTTGACA-1	Muscle
AGAGAGCCAGACACCC-1	Fibroblasts
AGAGAGCGTACGATCT-1	Myofibroblast_Mesothelium
AGAGAGCGTTACGTAC-1	Myofibroblast_Mesothelium
AGAGCAGTCATTGGTG-1	Fibroblasts
AGAGCAGTCCCAGGCA-1	Epithelial
AGAGCCCAGATGACCG-1	Immune
AGAGCCCAGTCATGCT-1	Fibroblasts
AGAGCCCGTCGCACGT-1	Myofibroblast_Mesothelium
AGATAGAAGTTGTAAG-1	Fibroblasts
AGATAGACATAACCCA-1	Endothelial
AGATAGAGTTCGGACC-1	Endothelial
AGATAGATCCGTACGG-1	Epithelial
AGATAGATCGATGCTA-1	Myofibroblast_Mesothelium
AGATAGATCTGAGGCC-1	Endothelial
AGATCCAAGCTGTGCC-1	Fibroblasts
AGATCCAAGTCTTCCC-1	Fibroblasts
AGATCCACAACGCCCA-1	Epithelial
AGATCCACACATCCCT-1	Muscle
AGATCCAGTCTCTCAC-1	Epithelial
AGATCCAGTCTGCATA-1	Myofibroblast_Mesothelium
AGATCCATCCTCTCGA-1	Epithelial
AGATCCATCGGTAACT-1	Myofibroblast_Mesothelium
AGATCCATCTATTCGT-1	Endothelial
AGATCGTCAATGGCAG-1	Fibroblasts
AGATCGTGTACGCTAT-1	Myofibroblast_Mesothelium
AGATCGTTCGCTTTAT-1	Fibroblasts
AGATGAAAGCACTCGC-1	Fibroblasts
AGATGAAAGGACATCG-1	Epithelial
AGATGAAAGTAGACAT-1	Epithelial
AGATGAACACCCTAGG-1	Myofibroblast_Mesothelium
AGATGAACATAATGAG-1	Epithelial
AGATGAATCCATTGCC-1	Epithelial
AGATGCTAGGCTCACC-1	Epithelial
AGATGCTGTTCCGCGA-1	Fibroblasts
AGATGCTTCATTGGTG-1	Neural
AGCATCAAGCATGAAT-1	Myofibroblast_Mesothelium
AGCATCAAGCGCCTAC-1	Epithelial
AGCATCAGTATGCTTG-1	Epithelial
AGCATCAGTCTGGTTA-1	Epithelial
AGCATCATCGGCCAAC-1	Muscle
AGCCAATAGACTTCGT-1	Neural
AGCCACGCACAGGATG-1	Epithelial
AGCCACGCAGTCGGAA-1	Myofibroblast_Mesothelium
AGCCAGCAGATGGTCG-1	Fibroblasts
AGCCAGCCAACAAAGT-1	Epithelial
AGCCAGCCAATAGGGC-1	Myofibroblast_Mesothelium
AGCCAGCCACTGAGTT-1	Fibroblasts
AGCCAGCCATGGCTGC-1	Epithelial
AGCCAGCGTTACCCTC-1	Pericytes
AGCCAGCGTTACTCAG-1	Endothelial
AGCCAGCTCGGCTGGT-1	Fibroblasts
AGCGATTAGAGATTCA-1	Endothelial
AGCGATTAGTCGGCCT-1	Fibroblasts
AGCGATTCAGCACACC-1	Epithelial
AGCGATTCATAACCCA-1	Fibroblasts
AGCGATTGTCATAACC-1	Fibroblasts
AGCGCCATCGAACGCC-1	Pericytes
AGCGCCATCGGACAAG-1	Epithelial
AGCGCTGAGGTCGCCT-1	Fibroblasts
AGCGCTGTCAATCGGT-1	Myofibroblast_Mesothelium
AGCGCTGTCCGCACTT-1	Myofibroblast_Mesothelium
AGCGCTGTCTGAGGCC-1	Fibroblasts
AGCGTATAGCACTTTG-1	Fibroblasts
AGCGTATAGGTACAAT-1	Myofibroblast_Mesothelium
AGCGTATCAAATGCGG-1	Myofibroblast_Mesothelium
AGCGTATTCCGATGTA-1	Muscle
AGCTACAAGCGCACAA-1	Fibroblasts
AGCTACAAGTTGCGCC-1	Myofibroblast_Mesothelium
AGCTACACAGGAATCG-1	Fibroblasts
AGCTACAGTATTCCTT-1	Fibroblasts
AGCTCAAAGCCTATCA-1	Epithelial
AGCTCAACACAAATCC-1	Fibroblasts
AGCTCAAGTCCAATCA-1	Fibroblasts
AGCTCAATCAAAGCCT-1	Fibroblasts
AGCTTCCCACGAGAAC-1	Epithelial
AGCTTCCCAGATCCAT-1	Fibroblasts
AGCTTCCGTCATGACT-1	Fibroblasts
AGCTTCCTCGTGGGAA-1	Fibroblasts
AGGAAATAGAGGGTCT-1	Epithelial
AGGAAATAGGCCTAGA-1	Epithelial
AGGAAATCATCTTTCA-1	Immune
AGGAAATGTGAGCCAA-1	Myofibroblast_Mesothelium
AGGAAATGTTGCTAGT-1	Epithelial
AGGAAATTCAGACAAA-1	Endothelial
AGGAAATTCGAGTGGA-1	Fibroblasts
AGGAAATTCTGGCTGG-1	Fibroblasts
AGGAATAAGCATGATA-1	Myofibroblast_Mesothelium
AGGAATAAGCTGCCTG-1	Muscle
AGGAATACACAATCTG-1	Epithelial
AGGAATAGTCACTGAT-1	Epithelial
AGGAATATCCTAACAG-1	Epithelial
AGGAATATCGATTGAC-1	Myofibroblast_Mesothelium
AGGAATATCTTAGGAC-1	Muscle
AGGACGAGTGACGCCT-1	Fibroblasts
AGGACGATCAAGTGGG-1	Neural
AGGACGATCGATTCCC-1	Epithelial
AGGACGATCGTAGCTA-1	Muscle
AGGACTTAGGTTCCAT-1	Fibroblasts
AGGACTTAGTCCCGAC-1	Fibroblasts
AGGACTTCAGAGATGC-1	Epithelial
AGGACTTCATCCGTGG-1	Fibroblasts
AGGACTTGTTCCCACT-1	Fibroblasts
AGGACTTGTTGACTGT-1	Epithelial
AGGACTTGTTTCACAG-1	Fibroblasts
AGGACTTTCGGCTATA-1	Neural
AGGAGGTAGCGCTGCT-1	Fibroblasts
AGGAGGTAGGAGAGGC-1	Immune
AGGAGGTAGGATGTTA-1	Epithelial
AGGAGGTCACGGTGTC-1	Immune
AGGAGGTGTCTAACGT-1	Epithelial
AGGAGGTGTGAGCAGT-1	Myofibroblast_Mesothelium
AGGAGGTGTGATACAA-1	Fibroblasts
AGGATAAAGAGCATAT-1	Fibroblasts
AGGATAAAGGAAGTGA-1	Fibroblasts
AGGATAACAATAGAGT-1	Pericytes
AGGATAACACCAGTTA-1	Fibroblasts
AGGATAAGTCTCAGGC-1	Epithelial
AGGATAATCCGGTAGC-1	Fibroblasts
AGGATCTCACCGCTAG-1	Fibroblasts
AGGATCTGTGTCATGT-1	Epithelial
AGGATCTTCGAGCTGC-1	Myofibroblast_Mesothelium
AGGCATTAGCTCCACG-1	Myofibroblast_Mesothelium
AGGCATTCACCCTGTT-1	Endothelial
AGGCATTCACGTTGGC-1	Fibroblasts
AGGCATTCATTGGCAT-1	Epithelial
AGGCATTTCCAAACCA-1	Fibroblasts
AGGCATTTCTCATGGA-1	Pericytes
AGGCCACAGGACAGTC-1	Neural
AGGCCACAGGATATAC-1	Pericytes
AGGCCACCACGATTCA-1	Neural
AGGCTGCAGAGTTCGG-1	Myofibroblast_Mesothelium
AGGCTGCCACACCGAC-1	Pericytes
AGGCTGCGTAAGTTGA-1	Neural
AGGCTGCGTGGCTTAT-1	Epithelial
AGGCTGCTCGTCGGGT-1	Pericytes
AGGCTGCTCTCGTTTA-1	Fibroblasts
AGGCTGCTCTGTTGGA-1	Pericytes
AGGGAGTAGCCTCTGG-1	Immune
AGGGAGTAGCTGGCTC-1	Endothelial
AGGGAGTCAAGTTCCA-1	Epithelial
AGGGAGTCATTCGATG-1	Myofibroblast_Mesothelium
AGGGAGTGTACCATAC-1	Endothelial
AGGGAGTGTTGAATCC-1	Fibroblasts
AGGGCCTGTTAAGCAA-1	Epithelial
AGGGCCTTCCTTCTAA-1	Epithelial
AGGGCTCAGAATAACC-1	Epithelial
AGGGCTCAGACGGAAA-1	Fibroblasts
AGGGCTCAGCACCTGC-1	Pericytes
AGGGCTCAGGGAGTTC-1	Fibroblasts
AGGGCTCCACGACTAT-1	Epithelial
AGGGCTCCACTACTTT-1	Fibroblasts
AGGGCTCTCGCCTATC-1	Neural
AGGGTCCAGTATTCCG-1	Epithelial
AGGGTCCAGTGTACAA-1	Epithelial
AGGGTCCCACACTGGC-1	Epithelial
AGGGTCCGTTAAACAG-1	Epithelial
AGGGTCCGTTGATGTC-1	Fibroblasts
AGGGTGACACATGACT-1	Fibroblasts
AGGGTGAGTATGTCAC-1	Epithelial
AGGGTTTAGAGGTGCT-1	Fibroblasts
AGGGTTTCATTGGCAT-1	Epithelial
AGGGTTTTCCCTCATG-1	Myofibroblast_Mesothelium
AGGTAGGAGGTTACAA-1	Myofibroblast_Mesothelium
AGGTAGGAGTGCAGCA-1	Neural
AGGTAGGCATCAGTGT-1	Epithelial
AGGTAGGTCGCTGCGA-1	Myofibroblast_Mesothelium
AGGTCATAGACTGGGT-1	Pericytes
AGGTCATAGATGATTG-1	Pericytes
AGGTCATCAATTGCCA-1	Pericytes
AGGTCATGTGGTTCTA-1	Pericytes
AGGTCATTCTTGGCTC-1	Pericytes
AGGTCTAAGCCACTCG-1	Pericytes
AGGTCTACAAAGACTA-1	Epithelial
AGGTCTACACTTGGCG-1	Epithelial
AGGTCTACAGCTGCCA-1	Epithelial
AGGTCTAGTACCGTGC-1	Pericytes
AGGTCTAGTGCGGCTT-1	Epithelial
AGGTCTAGTTTGGGTT-1	Epithelial
AGGTCTATCTCAAAGC-1	Pericytes
AGGTGTTGTCACTCAA-1	Epithelial
AGGTTACCAACCGTAT-1	Fibroblasts
AGGTTACCACGTCGTG-1	Myofibroblast_Mesothelium
AGGTTACCAGCAAGAC-1	Epithelial
AGGTTACCAGCTGGTC-1	Muscle
AGGTTACCAGGTAGTG-1	Fibroblasts
AGGTTACCAGGTCCGT-1	Endothelial
AGGTTACTCTCCTACG-1	Epithelial
AGGTTGTAGCCTCAGC-1	Fibroblasts
AGGTTGTCAGAGGTTG-1	Fibroblasts
AGGTTGTGTAATACCC-1	Fibroblasts
AGGTTGTGTCTTCCGT-1	Epithelial
AGGTTGTTCCAACACA-1	Myofibroblast_Mesothelium
AGTAACCAGCACAAAT-1	Epithelial
AGTAACCCAAGAAACT-1	Epithelial
AGTAACCCAATTGGTC-1	Fibroblasts
AGTAACCCAGTAGGAC-1	Myofibroblast_Mesothelium
AGTAACCTCACTGTCC-1	Epithelial
AGTAACCTCGCATTAG-1	Epithelial
AGTACCAAGCTCTTCC-1	Fibroblasts
AGTACCAAGGTCATAA-1	Endothelial
AGTACCACAATCGCGC-1	Fibroblasts
AGTACCACATGCCGGT-1	Fibroblasts
AGTACCAGTGACTCTA-1	Epithelial
AGTACTGAGGTCGTGA-1	Epithelial
AGTACTGGTATGTCTG-1	Pericytes
AGTACTGTCTACACTT-1	Epithelial
AGTAGCTCACCCTTGT-1	Muscle
AGTAGCTCACTCCCTA-1	Epithelial
AGTAGCTCAGCCGTCA-1	Fibroblasts
AGTAGCTGTTCTCTCG-1	Fibroblasts
AGTAGCTTCGCAGATT-1	Muscle
AGTAGCTTCTACTCAT-1	Epithelial
AGTAGCTTCTCATTGT-1	Neural
AGTAGCTTCTTTGCAT-1	Muscle
AGTAGTCCATCTAGAC-1	Fibroblasts
AGTAGTCTCGGCATCG-1	Myofibroblast_Mesothelium
AGTCAACAGACTTGTC-1	Fibroblasts
AGTCAACCAATCCTAG-1	Fibroblasts
AGTCAACGTAGGACTG-1	Pericytes
AGTCAACGTTATAGCC-1	Fibroblasts
AGTCAACGTTCTCACC-1	Epithelial
AGTCAACGTTGCGTAT-1	Epithelial
AGTCAACTCAAGCCGC-1	Fibroblasts
AGTCAACTCGGTCGGT-1	Epithelial
AGTCACAAGCGCAATG-1	Myofibroblast_Mesothelium
AGTCACACAGGTGTTT-1	Fibroblasts
AGTCACACATGTCAGT-1	Muscle
AGTCACAGTCTACACA-1	Fibroblasts
AGTCACAGTGAGACCA-1	Endothelial
AGTCACATCCGTGTAA-1	Endothelial
AGTCATGAGATGACAT-1	Fibroblasts
AGTCATGAGGAATTAC-1	Epithelial
AGTCATGAGGCGCTCT-1	Muscle
AGTCATGGTCACATTG-1	Fibroblasts
AGTCATGTCAACCGAT-1	Muscle
AGTCATGTCAACTCTT-1	Epithelial
AGTCATGTCCCTTTGG-1	Epithelial
AGTCTCCCATTGCCGG-1	Myofibroblast_Mesothelium
AGTCTCCTCGCAGTTA-1	Epithelial
AGTGACTAGGAGTATT-1	Muscle
AGTGACTCACTTCTCG-1	Neural
AGTGACTGTAAGATAC-1	Epithelial
AGTGACTGTGGTAACG-1	Myofibroblast_Mesothelium
AGTGACTTCCGAGGCT-1	Fibroblasts
AGTGATCAGCGACTGA-1	Endothelial
AGTGATCAGCGATGAC-1	Fibroblasts
AGTGATCAGTGCACCC-1	Fibroblasts
AGTGATCCACCCTTGT-1	Pericytes
AGTGATCCAGGTGTTT-1	Epithelial
AGTGATCTCCGGGACT-1	Pericytes
AGTGCCGAGACGGTCA-1	Neural
AGTGCCGCACACCGAC-1	Myofibroblast_Mesothelium
AGTGCCGCACGTTCGG-1	Epithelial
AGTGCCGGTCACTCGG-1	Fibroblasts
AGTGCCGGTTGGCTAT-1	Myofibroblast_Mesothelium
AGTGTTGAGGTCTTTG-1	Fibroblasts
AGTGTTGTCAAGAATG-1	Immune
AGTGTTGTCGATTGAC-1	Epithelial
AGTTAGCCATGACCCG-1	Myofibroblast_Mesothelium
AGTTAGCGTACCGTCG-1	Epithelial
AGTTAGCGTATGCGGA-1	Fibroblasts
AGTTAGCGTCACCTTC-1	Myofibroblast_Mesothelium
AGTTAGCGTCTGCCTT-1	Fibroblasts
AGTTAGCGTGTCCCTT-1	Epithelial
AGTTAGCTCATCACCC-1	Pericytes
AGTTAGCTCCATCTCG-1	Fibroblasts
AGTTCCCAGGGCTTCC-1	Fibroblasts
AGTTCCCCACCTTCCA-1	Myofibroblast_Mesothelium
AGTTCCCCACGAGGTA-1	Epithelial
AGTTCCCGTCATGGCC-1	Epithelial
AGTTCCCTCCTGTACC-1	Epithelial
AGTTCGACAACGGCCT-1	Myofibroblast_Mesothelium
AGTTCGACACCAGTTA-1	Pericytes
AGTTCGAGTGTATTCG-1	Fibroblasts
AGTTCGATCCGACAGC-1	Fibroblasts
AGTTCGATCTCATGGA-1	Pericytes
ATACCGAAGCTCGGCT-1	Fibroblasts
ATACCGAAGGCACAAC-1	Fibroblasts
ATACCGAAGGTCCTGC-1	Neural
ATACCGAGTTCTCGCT-1	Fibroblasts
ATACCGATCAGCTTCC-1	Myofibroblast_Mesothelium
ATACCTTCACTAGTAC-1	Fibroblasts
ATACCTTGTATCATGC-1	Endothelial
ATACCTTGTGCACATT-1	Endothelial
ATACCTTTCAAAGCCT-1	Fibroblasts
ATACCTTTCCTAGCTC-1	Myofibroblast_Mesothelium
ATACTTCAGGACTGGT-1	Epithelial
ATACTTCCAGGACAGT-1	Fibroblasts
ATACTTCGTCATGACT-1	Pericytes
ATACTTCGTCGCTGCA-1	Fibroblasts
ATACTTCGTCGTTCAA-1	Epithelial
ATACTTCTCACGACTA-1	Epithelial
ATACTTCTCGGAGCAA-1	Fibroblasts
ATAGACCAGGCTGTAG-1	Epithelial
ATAGACCCAAGACCGA-1	Epithelial
ATAGACCCAAGGATGC-1	Epithelial
ATAGACCCAGATTAAG-1	Epithelial
ATAGACCGTTTACTGG-1	Fibroblasts
ATAGAGAAGTATTAGG-1	Pericytes
ATAGAGAAGTTTGTCG-1	Endothelial
ATAGAGATCACCTACC-1	Neural
ATAGAGATCCCTTGGT-1	Myofibroblast_Mesothelium
ATAGGCTGTATAATGG-1	Fibroblasts
ATAGGCTGTATGATCC-1	Epithelial
ATAGGCTTCATTTCGT-1	Myofibroblast_Mesothelium
ATAGGCTTCCAACACA-1	Fibroblasts
ATAGGCTTCCGTAGGC-1	Epithelial
ATAGGCTTCCTTGACC-1	Myofibroblast_Mesothelium
ATATCCTAGCATCAAA-1	Epithelial
ATATCCTAGCCTCTCT-1	Myofibroblast_Mesothelium
ATATCCTTCGACGAGA-1	Neural
ATCACAGAGAAGTCCG-1	Endothelial
ATCACAGAGACCAGCA-1	Fibroblasts
ATCACAGAGTCACTAC-1	Fibroblasts
ATCACAGCATCACCAA-1	Epithelial
ATCACAGGTCGCTCGA-1	Epithelial
ATCACAGGTTAGTTCG-1	Fibroblasts
ATCACAGTCTAATTCC-1	Fibroblasts
ATCACGAAGCGCCTAC-1	Epithelial
ATCACGAAGTGCAACG-1	Fibroblasts
ATCACGATCGCGAAGA-1	Pericytes
ATCACGATCTCATGCC-1	Epithelial
ATCACTTAGCGATGGT-1	Fibroblasts
ATCACTTAGGTTCAGG-1	Endothelial
ATCACTTCACTGTGTA-1	Fibroblasts
ATCACTTGTGTTCCAA-1	Epithelial
ATCACTTGTTTACGTG-1	Fibroblasts
ATCACTTTCCAAGGGA-1	Epithelial
ATCAGGTCAGAGTGTG-1	Epithelial
ATCAGGTCAGTAACGG-1	Fibroblasts
ATCAGGTGTACAGCGA-1	Fibroblasts
ATCAGGTGTTGCCATA-1	Epithelial
ATCAGGTTCCAAATGC-1	Muscle
ATCAGGTTCTCATAGG-1	Fibroblasts
ATCATTCAGGTGCCAA-1	Myofibroblast_Mesothelium
ATCATTCCAACCGATT-1	Myofibroblast_Mesothelium
ATCATTCGTCGAGTGA-1	Fibroblasts
ATCATTCTCGGCGATC-1	Endothelial
ATCCACCCATGAATAG-1	Myofibroblast_Mesothelium
ATCCACCGTACAAGTA-1	Fibroblasts
ATCCACCGTAGCGTTT-1	Epithelial
ATCCACCTCGTCTACC-1	Epithelial
ATCCATTGTATAGCTC-1	Endothelial
ATCCATTTCGGACTTA-1	Myofibroblast_Mesothelium
ATCCCTGAGTTGGAAT-1	Fibroblasts
ATCCCTGCAACATACC-1	Epithelial
ATCCCTGCAAGCGCAA-1	Myofibroblast_Mesothelium
ATCCCTGTCTCCTGTG-1	Endothelial
ATCCGTCAGACGATAT-1	Pericytes
ATCCGTCAGGGCTAAC-1	Epithelial
ATCCGTCAGTGCAGCA-1	Fibroblasts
ATCCGTCCACTCCTGT-1	Endothelial
ATCCTATAGTGCAGCA-1	Epithelial
ATCCTATCACTGTGTA-1	Epithelial
ATCCTATCATCAGTCA-1	Fibroblasts
ATCCTATGTGCAACGA-1	Endothelial
ATCCTATGTTCCATTT-1	Epithelial
ATCGATGCAAGCCTGC-1	Fibroblasts
ATCGATGGTCTCTCTG-1	Epithelial
ATCGATGTCAAAGACA-1	Endothelial
ATCGCCTCAATCAAGA-1	Fibroblasts
ATCGCCTCACTACCGG-1	Fibroblasts
ATCGCCTGTTCAAACC-1	Fibroblasts
ATCGCCTTCATGAGTC-1	Myofibroblast_Mesothelium
ATCGGATAGAGCAGCT-1	Epithelial
ATCGGATCAAGCTGTT-1	Epithelial
ATCGGATCACTGCGAC-1	Pericytes
ATCGGATGTTGGCTAT-1	Myofibroblast_Mesothelium
ATCGGATTCGGCCAAC-1	Fibroblasts
ATCGGCGAGCACCTGC-1	Muscle
ATCGGCGAGTCTACCA-1	Endothelial
ATCGGCGGTGGGTATG-1	Fibroblasts
ATCGGCGGTTGTAAAG-1	Immune
ATCGGCGTCGGTCACG-1	Neural
ATCGTAGAGGTAAGTT-1	Epithelial
ATCGTAGCACATTCTT-1	Epithelial
ATCGTAGCAGGGCTTC-1	Epithelial
ATCGTCCAGTGACCTT-1	Epithelial
ATCGTCCCATCCGAGC-1	Fibroblasts
ATCGTCCGTCTACAAC-1	Pericytes
ATCGTCCTCCATCTGC-1	Fibroblasts
ATCGTGACATCATCTT-1	Epithelial
ATCGTGAGTGCCCAGT-1	Fibroblasts
ATCTCTACAAGAGCTG-1	Endothelial
ATCTCTACATAACCCA-1	Fibroblasts
ATCTCTAGTTCCCACT-1	Epithelial
ATCTCTATCCGTCACT-1	Endothelial
ATCTTCAAGATGCTGG-1	Fibroblasts
ATCTTCAAGGAGTATT-1	Fibroblasts
ATCTTCAAGTGTTCAC-1	Endothelial
ATCTTCACAAAGTGTA-1	Muscle
ATGAAAGCACAATGTC-1	Neural
ATGAAAGGTAACACCT-1	Fibroblasts
ATGAAAGGTGCCTGCA-1	Immune
ATGAAAGTCATCACCC-1	Neural
ATGAAAGTCTGGGCGT-1	Pericytes
ATGACCAAGTTTGTCG-1	Epithelial
ATGACCACACACCTTC-1	Fibroblasts
ATGAGGGAGGGAGATA-1	Muscle
ATGAGGGCAAGGTCAG-1	Neural
ATGAGGGCATCCTTGC-1	Epithelial
ATGAGGGGTCGAGCTC-1	Endothelial
ATGAGGGGTCGCTGCA-1	Muscle
ATGAGGGGTGGAACAC-1	Fibroblasts
ATGAGGGGTGTCATTG-1	Fibroblasts
ATGAGTCAGTACGTCT-1	Epithelial
ATGATCGAGGCTAACG-1	Myofibroblast_Mesothelium
ATGATCGCATCTATCT-1	Fibroblasts
ATGATCGGTAGTGGCA-1	Endothelial
ATGATCGTCGCAATGT-1	Epithelial
ATGCATGAGGCGTTGA-1	Neural
ATGCATGGTTAAAGTG-1	Endothelial
ATGCATGTCTCGGGAC-1	Endothelial
ATGCCTCCACGACAGA-1	Fibroblasts
ATGCCTCGTCGCGTTG-1	Fibroblasts
ATGCGATAGGCTGAAC-1	Epithelial
ATGCGATCAAGAGTGC-1	Fibroblasts
ATGCGATGTACCGGCT-1	Epithelial
ATGCGATTCTCAGGCG-1	Epithelial
ATGGAGGCAGTAGTTC-1	Epithelial
ATGGAGGGTTGTTTGG-1	Endothelial
ATGGAGGTCCCGTTCA-1	Pericytes
ATGGAGGTCGGTTAGT-1	Neural
ATGGATCAGAACGCGT-1	Myofibroblast_Mesothelium
ATGGATCAGGCGATAC-1	Fibroblasts
ATGGATCAGGGAACAA-1	Fibroblasts
ATGGATCAGGGTTAGC-1	Fibroblasts
ATGGATCAGTGCAACG-1	Pericytes
ATGGATCCAATACCCA-1	Fibroblasts
ATGGATCGTACACGCC-1	Epithelial
ATGGATCTCGAGAGCA-1	Epithelial
ATGGGAGAGCCTTTCC-1	Muscle
ATGGGAGAGGTCACAG-1	Myofibroblast_Mesothelium
ATGGGAGCACAAATGA-1	Muscle
ATGGGAGCAGGGATAC-1	Neural
ATGGGAGTCGATTGGT-1	Myofibroblast_Mesothelium
ATGGGTTCAAGAAACT-1	Fibroblasts
ATGGGTTCACATAGCT-1	Epithelial
ATGGGTTCAGACCATT-1	Fibroblasts
ATGGGTTTCTCTATAC-1	Fibroblasts
ATGGTTGCACTCCTGT-1	Fibroblasts
ATGGTTGCACTTCAAG-1	Epithelial
ATGGTTGTCCGCGAGT-1	Endothelial
ATGTCCCAGAGTCTGG-1	Fibroblasts
ATGTCCCCAAGTAGTA-1	Fibroblasts
ATGTCCCCACCCTGTT-1	Pericytes
ATGTCCCCAGGTTACT-1	Fibroblasts
ATGTCCCGTTGTATGC-1	Epithelial
ATGTCCCGTTTAAGGA-1	Neural
ATGTCCCTCGAGTGGA-1	Myofibroblast_Mesothelium
ATGTCTTAGATCCAAA-1	Endothelial
ATGTCTTCAAATAGCA-1	Epithelial
ATGTCTTCACTTGGGC-1	Fibroblasts
ATGTCTTGTACGGATG-1	Pericytes
ATGTCTTTCCCGAATA-1	Fibroblasts
ATGTCTTTCGGACTTA-1	Epithelial
ATTACCTCAAAGTGTA-1	Endothelial
ATTACCTCACCGTGGT-1	Epithelial
ATTACCTCAGACACAG-1	Fibroblasts
ATTACCTCAGCACACC-1	Fibroblasts
ATTACCTCAGGACGAT-1	Epithelial
ATTACCTGTAGATCCT-1	Fibroblasts
ATTACCTGTTCTTCAT-1	Epithelial
ATTACCTTCGAGTGGA-1	Pericytes
ATTACCTTCGATGGAG-1	Epithelial
ATTACTCAGTTAACGA-1	Pericytes
ATTACTCGTAAGATCA-1	Fibroblasts
ATTACTCTCACTTGTT-1	Muscle
ATTATCCAGATAACAC-1	Endothelial
ATTATCCAGTCATACC-1	Myofibroblast_Mesothelium
ATTATCCCAGACAAGC-1	Endothelial
ATTCACTAGCGGTATG-1	Epithelial
ATTCAGGAGGAGGGTG-1	Myofibroblast_Mesothelium
ATTCAGGAGGCACAAC-1	Myofibroblast_Mesothelium
ATTCAGGAGGCGTCCT-1	Myofibroblast_Mesothelium
ATTCAGGAGTGCCGAA-1	Fibroblasts
ATTCAGGCAAGTTTGC-1	Endothelial
ATTCAGGGTCCACACG-1	Neural
ATTCATCAGACTGTTC-1	Epithelial
ATTCATCCAAGTACCT-1	Fibroblasts
ATTCATCCACCTCTGT-1	Muscle
ATTCATCCAGCGGTCT-1	Fibroblasts
ATTCATCGTACAGAAT-1	Myofibroblast_Mesothelium
ATTCATCTCCACGTAA-1	Fibroblasts
ATTCCATGTAACCAGG-1	Endothelial
ATTCCATGTATCGGTT-1	Epithelial
ATTCCATGTCGAACAG-1	Pericytes
ATTCCATTCCGAGTGC-1	Myofibroblast_Mesothelium
ATTCCCGAGGACCCAA-1	Fibroblasts
ATTCCCGAGGTTATAG-1	Epithelial
ATTCCCGGTCTTGCGG-1	Pericytes
ATTCCCGGTGTTGATC-1	Fibroblasts
ATTCCCGTCCGACGGT-1	Fibroblasts
ATTCCTAAGCTGTTCA-1	Epithelial
ATTCCTAAGCTTTCTT-1	Myofibroblast_Mesothelium
ATTCCTACATTGTCGA-1	Epithelial
ATTCCTAGTTAAGGGC-1	Myofibroblast_Mesothelium
ATTCCTAGTTGACTGT-1	Fibroblasts
ATTCGTTGTACGTTCA-1	Epithelial
ATTCGTTTCGAACCAT-1	Fibroblasts
ATTCTACAGCACGTCC-1	Epithelial
ATTCTACAGTCTTCCC-1	Epithelial
ATTCTACCAAATCAAG-1	Fibroblasts
ATTCTACCACTATCCC-1	Epithelial
ATTCTACCAGTGGGTA-1	Myofibroblast_Mesothelium
ATTCTACCATTACTCT-1	Epithelial
ATTCTACGTATTGCCA-1	Epithelial
ATTCTACTCACAGTGT-1	Fibroblasts
ATTCTACTCCATGATG-1	Epithelial
ATTCTACTCTAACACG-1	Neural
ATTCTTGAGTGGAAGA-1	Epithelial
ATTCTTGCATACAGGG-1	Fibroblasts
ATTCTTGGTAGCTTTG-1	Muscle
ATTCTTGGTTGTAAAG-1	Fibroblasts
ATTCTTGTCCTCCACA-1	Fibroblasts
ATTCTTGTCTGACGCG-1	Fibroblasts
ATTCTTGTCTTAGGAC-1	Endothelial
ATTGGGTAGTTATGGA-1	Myofibroblast_Mesothelium
ATTGGGTCACGGCGTT-1	Fibroblasts
ATTGGGTCAGACCATT-1	Epithelial
ATTGGGTGTACGGGAT-1	Neural
ATTGGGTTCCGGGACT-1	Fibroblasts
ATTGTTCAGCTCTATG-1	Epithelial
ATTGTTCAGGCATGCA-1	Epithelial
ATTGTTCAGGTTCTTG-1	Fibroblasts
ATTGTTCCATCCGGTG-1	Pericytes
ATTGTTCGTAACAAGT-1	Immune
ATTGTTCGTTAGAAAC-1	Myofibroblast_Mesothelium
ATTGTTCTCTTCTCAA-1	Fibroblasts
ATTTACCAGGTCCTGC-1	Myofibroblast_Mesothelium
ATTTACCAGTCAGAGC-1	Epithelial
ATTTACCCAAATCGGG-1	Pericytes
ATTTCACCACTGGACC-1	Endothelial
ATTTCACGTACCCAGC-1	Fibroblasts
ATTTCACTCATGTCAG-1	Epithelial
ATTTCTGAGCGCACAA-1	Myofibroblast_Mesothelium
ATTTCTGAGTCACTAC-1	Fibroblasts
ATTTCTGCAGCATCTA-1	Epithelial
ATTTCTGGTAAGAACT-1	Epithelial
ATTTCTGTCAAGAGTA-1	Epithelial
CAAAGAAAGCCATTGT-1	Muscle
CAAAGAAAGGACTATA-1	Endothelial
CAAAGAACAGGAGGTT-1	Neural
CAAAGAACATGGCTAT-1	Pericytes
CAAAGAAGTCTGTAAC-1	Epithelial
CAAAGAATCGTGCAGC-1	Epithelial
CAACAACAGCACTAGG-1	Fibroblasts
CAACAACCAGGCTCTG-1	Fibroblasts
CAACAACCAGTTGGTT-1	Epithelial
CAACAACGTCCACTTC-1	Muscle
CAACAGTGTCCCTGTT-1	Pericytes
CAACAGTGTGGATACG-1	Myofibroblast_Mesothelium
CAACAGTTCCTCAGAA-1	Pericytes
CAACAGTTCTGGTGGC-1	Epithelial
CAACCAAAGCTCCCTT-1	Myofibroblast_Mesothelium
CAACCAAAGTGCCAGA-1	Fibroblasts
CAACCAACAAGACAAT-1	Fibroblasts
CAACCAAGTTGGTGTT-1	Fibroblasts
CAACCAATCAGTGATC-1	Epithelial
CAACCAATCATACGGT-1	Epithelial
CAACCAATCGGAAGGT-1	Immune
CAACCTCAGGTTCTTG-1	Neural
CAACCTCCAACGTATC-1	Epithelial
CAACCTCCAATAGAGT-1	Neural
CAACCTCCACGCTGCA-1	Fibroblasts
CAACCTCGTTAAACCC-1	Myofibroblast_Mesothelium
CAACGATAGTCTGTAC-1	Fibroblasts
CAACGATGTACCATAC-1	Fibroblasts
CAACGATGTCATGGCC-1	Epithelial
CAACGATGTGATCGTT-1	Fibroblasts
CAACGGCAGGACAGTC-1	Fibroblasts
CAACGGCCATAACGGG-1	Fibroblasts
CAACGGCGTCAGTCCG-1	Fibroblasts
CAACGGCGTCCTATAG-1	Epithelial
CAACGGCGTTGGACCC-1	Epithelial
CAACGGCTCATTTACC-1	Fibroblasts
CAACGGCTCGAGTCTA-1	Epithelial
CAAGACTAGGACTATA-1	Epithelial
CAAGACTAGGCCACCT-1	Epithelial
CAAGACTGTGAACTAA-1	Fibroblasts
CAAGACTGTGCAATAA-1	Myofibroblast_Mesothelium
CAAGACTTCCACTTTA-1	Myofibroblast_Mesothelium
CAAGACTTCCATATGG-1	Fibroblasts
CAAGACTTCGAGAACG-1	Neural
CAAGAGGAGGCCACCT-1	Neural
CAAGAGGGTTGCACGC-1	Epithelial
CAAGAGGTCGCAGTTA-1	Neural
CAAGAGGTCGGTGAAG-1	Epithelial
CAAGCTAAGCTGCCTG-1	Pericytes
CAAGCTACAGCGGTCT-1	Fibroblasts
CAAGCTAGTGATGTAA-1	Neural
CAAGCTATCACGATCA-1	Fibroblasts
CAAGCTATCATCGACA-1	Epithelial
CAAGGGAAGATGGCGT-1	Myofibroblast_Mesothelium
CAAGGGAGTCGGATTT-1	Epithelial
CAAGGGAGTCTTGAAC-1	Neural
CAAGGGAGTGATACTC-1	Myofibroblast_Mesothelium
CAAGGGATCCTTATAC-1	Fibroblasts
CAAGGGATCTAGTGAC-1	Fibroblasts
CAAGGGATCTGGTGGC-1	Fibroblasts
CAATACGAGACGCTCC-1	Endothelial
CAATACGCAGAAGCTG-1	Epithelial
CAATACGGTAGATTGA-1	Muscle
CAATACGTCCTGTTAT-1	Myofibroblast_Mesothelium
CAATCGACAACGGGTA-1	Pericytes
CAATCGACAAGAGATT-1	Muscle
CAATCGACACGGCGTT-1	Fibroblasts
CAATCGACATCTTCGC-1	Epithelial
CAATCGAGTTATCTGG-1	Epithelial
CAATCGATCCACAGGC-1	Myofibroblast_Mesothelium
CAATGACAGTTTGGCT-1	Muscle
CAATGACCAAACTAGA-1	Fibroblasts
CAATGACCAATCTCTT-1	Epithelial
CAATGACCATGACGGA-1	Fibroblasts
CAATGACGTGAAGCTG-1	Neural
CAATTTCAGAAGTGTT-1	Neural
CAATTTCAGCGGACAT-1	Fibroblasts
CAATTTCCAAATACAG-1	Epithelial
CAATTTCTCAGATTGC-1	Fibroblasts
CAATTTCTCATTTGTC-1	Epithelial
CACAACACAAGGTACG-1	Fibroblasts
CACAACATCCCTCGAT-1	Fibroblasts
CACAACATCCTCGATC-1	Fibroblasts
CACAACATCGAAGCAG-1	Epithelial
CACACAAAGAAAGCGA-1	Epithelial
CACACAAAGTAACCTC-1	Epithelial
CACACAACAGCTCTGG-1	Neural
CACACAATCTACTTCA-1	Myofibroblast_Mesothelium
CACAGATCACGACAAG-1	Neural
CACAGATCAGGTAGTG-1	Pericytes
CACAGATTCAGCCCAG-1	Fibroblasts
CACAGGCAGGTAAGGA-1	Endothelial
CACAGGCGTAACAGGC-1	Epithelial
CACAGGCGTTCAAACC-1	Myofibroblast_Mesothelium
CACAGGCTCGTGGGTC-1	Epithelial
CACAGGCTCTAACGCA-1	Fibroblasts
CACATGAAGAGCACTG-1	Pericytes
CACATGAAGGAGATAG-1	Fibroblasts
CACATGACAAGAGGCT-1	Fibroblasts
CACATGACAGTCGCAC-1	Fibroblasts
CACATGACATGACTCA-1	Immune
CACATGAGTGTTGCCG-1	Pericytes
CACATGATCGTAACAC-1	Epithelial
CACCAAACATAATGCC-1	Epithelial
CACCAAACATTCGATG-1	Myofibroblast_Mesothelium
CACCAAAGTGGCCTCA-1	Fibroblasts
CACCAAAGTGTCATCA-1	Epithelial
CACCAAATCACCCTTG-1	Epithelial
CACCGTTAGCATCAGG-1	Epithelial
CACCGTTAGCTCTTCC-1	Fibroblasts
CACCGTTCAATCTGCA-1	Immune
CACCGTTCACCAGTTA-1	Epithelial
CACCGTTCATCGTTCC-1	Pericytes
CACCGTTGTACTTGTG-1	Fibroblasts
CACCGTTGTGTAACGG-1	Fibroblasts
CACCGTTTCCACGTAA-1	Neural
CACGAATAGGTTATAG-1	Myofibroblast_Mesothelium
CACGAATCAGCAGAAC-1	Epithelial
CACGAATGTACTCGTA-1	Fibroblasts
CACGGGTCACAAACGG-1	Epithelial
CACGTGGAGTCGCCAC-1	Myofibroblast_Mesothelium
CACGTGGCATGGCTAT-1	Fibroblasts
CACGTGGCATTGCAAC-1	Fibroblasts
CACGTGGGTCCACAGC-1	Muscle
CACGTTCAGCTCACTA-1	Pericytes
CACGTTCGTAATGATG-1	Fibroblasts
CACGTTCTCCGTTGAA-1	Fibroblasts
CACGTTCTCTTTGCAT-1	Fibroblasts
CACTAAGGTCCTTAAG-1	Neural
CACTAAGGTCTTGCGG-1	Neural
CACTAAGGTTGAAGTA-1	Epithelial
CACTAAGTCAGCTGAT-1	Fibroblasts
CACTAAGTCCTCACTG-1	Fibroblasts
CACTAAGTCGCTCTAC-1	Fibroblasts
CACTAAGTCGGCTTCT-1	Fibroblasts
CACTGAAAGAAGCGGG-1	Fibroblasts
CACTGAAAGACAACTA-1	Fibroblasts
CACTGAAAGATTGTGA-1	Pericytes
CACTGAAAGGTCGACA-1	Epithelial
CACTGAACACAGTACT-1	Myofibroblast_Mesothelium
CACTGAACAGACGGAT-1	Myofibroblast_Mesothelium
CACTGAACAGTTGTCA-1	Fibroblasts
CACTGAAGTCGGATTT-1	Neural
CACTGAAGTTAATGAG-1	Epithelial
CACTGAATCAGCCTCT-1	Epithelial
CACTGAATCGCGAAGA-1	Myofibroblast_Mesothelium
CACTGGGCAACTCCCT-1	Epithelial
CACTGGGCATGGGATG-1	Epithelial
CACTGGGGTCGCACAC-1	Epithelial
CACTGGGGTTCTCGTC-1	Neural
CACTGGGTCACCCTCA-1	Neural
CACTGGGTCACGGGCT-1	Epithelial
CACTGGGTCATCACTT-1	Neural
CACTGTCCAACCAATC-1	Epithelial
CACTGTCCACCCTTAC-1	Epithelial
CACTGTCCATAACAGA-1	Myofibroblast_Mesothelium
CACTGTCGTCAATCTG-1	Immune
CACTGTCTCGGATTAC-1	Epithelial
CACTGTCTCTACCCAC-1	Myofibroblast_Mesothelium
CACTGTCTCTTAATCC-1	Immune
CACTTCGAGCAAGGAA-1	Myofibroblast_Mesothelium
CACTTCGAGCAGAAAG-1	Fibroblasts
CACTTCGCACGGTGTC-1	Neural
CACTTCGGTAGTGTGG-1	Fibroblasts
CACTTCGGTGCAACAG-1	Myofibroblast_Mesothelium
CACTTCGGTGTAGCAG-1	Fibroblasts
CACTTCGTCCACACAA-1	Epithelial
CACTTCGTCTTCACGC-1	Fibroblasts
CAGAGCCCACCCTAAA-1	Myofibroblast_Mesothelium
CAGAGCCCATGGCGCT-1	Muscle
CAGAGCCGTTCGTACA-1	Fibroblasts
CAGAGCCGTTCTCCCA-1	Epithelial
CAGAGCCTCAACTCTT-1	Epithelial
CAGATACCAACCAATC-1	Fibroblasts
CAGATACCAAGCCCAC-1	Neural
CAGATACCATATGAAG-1	Endothelial
CAGATACGTACAGAAT-1	Neural
CAGATACGTACTTGTG-1	Myofibroblast_Mesothelium
CAGATACGTGAAGCTG-1	Epithelial
CAGATACGTGACTATC-1	Epithelial
CAGATACTCATGGTAC-1	Myofibroblast_Mesothelium
CAGATACTCCGATAGT-1	Epithelial
CAGATACTCCTCTAGC-1	Myofibroblast_Mesothelium
CAGATACTCGGTGCAC-1	Epithelial
CAGATACTCTGCACCT-1	Fibroblasts
CAGATACTCTGCTTAT-1	Endothelial
CAGATCACAATCCAGT-1	Epithelial
CAGATCAGTCACCTTC-1	Fibroblasts
CAGATCATCTACCCAC-1	Fibroblasts
CAGATTGAGCGTCAAG-1	Epithelial
CAGATTGCAACAAAGT-1	Fibroblasts
CAGATTGCATGTGCTA-1	Fibroblasts
CAGCAATAGAGAGAAC-1	Pericytes
CAGCAATAGCATCCCG-1	Fibroblasts
CAGCAATAGGCCGCTT-1	Fibroblasts
CAGCAATCAACCACAT-1	Epithelial
CAGCAATCATATGAAG-1	Endothelial
CAGCAATGTTCTCCAC-1	Epithelial
CAGCAATTCAAATGAG-1	Epithelial
CAGCACGAGAGGATCC-1	Endothelial
CAGCACGAGCTAATCC-1	Epithelial
CAGCACGAGTTACTCG-1	Myofibroblast_Mesothelium
CAGCACGCACCAATTG-1	Pericytes
CAGCACGTCTGTGCAA-1	Neural
CAGCAGCCAAGCCATT-1	Epithelial
CAGCAGCCATGGTACT-1	Epithelial
CAGCAGCGTCTGTAAC-1	Epithelial
CAGCAGCTCCTGTTGC-1	Epithelial
CAGCAGCTCTGCTGAA-1	Fibroblasts
CAGCCAGAGCTCCATA-1	Fibroblasts
CAGCCAGCAAATGCGG-1	Immune
CAGCCAGCACTACGGC-1	Endothelial
CAGCCAGGTCAAACGG-1	Neural
CAGCCAGTCGAACGCC-1	Fibroblasts
CAGCGTGAGAGGTTAT-1	Epithelial
CAGCGTGCAAGGCCTC-1	Endothelial
CAGCGTGTCGAGAAAT-1	Neural
CAGGCCAAGGAGAGTA-1	Immune
CAGGCCACAGCCATTA-1	Epithelial
CAGGCCACAGTCCGTG-1	Epithelial
CAGGCCACATGGAAGC-1	Fibroblasts
CAGGCCAGTCATCCCT-1	Epithelial
CAGGCCATCGGTAGAG-1	Epithelial
CAGGGCTCAAGAGTAT-1	Endothelial
CAGGGCTGTGTCATTG-1	Fibroblasts
CAGGGCTTCAACCGAT-1	Fibroblasts
CAGGTATGTAGAATGT-1	Muscle
CAGGTATGTTAACCTG-1	Fibroblasts
CAGGTATTCCCGAACG-1	Epithelial
CAGGTATTCTATTCGT-1	Endothelial
CAGGTATTCTGAGAGG-1	Myofibroblast_Mesothelium
CAGTGCGAGAACAAGG-1	Immune
CAGTGCGAGAGCAGAA-1	Epithelial
CAGTGCGAGGCGTTAG-1	Fibroblasts
CAGTGCGAGGGTTAGC-1	Fibroblasts
CAGTGCGGTAACCAGG-1	Epithelial
CAGTGCGGTGATCATC-1	Pericytes
CAGTGCGGTGCTGCAC-1	Fibroblasts
CAGTGCGGTTGTTGAC-1	Fibroblasts
CAGTGCGTCCCGAAAT-1	Epithelial
CAGTGCGTCTCGTCAC-1	Epithelial
CAGTTAGCAGTTAAAG-1	Myofibroblast_Mesothelium
CAGTTAGGTATGGTTC-1	Pericytes
CAGTTAGGTCAGTCTA-1	Fibroblasts
CAGTTAGTCACCGCTT-1	Epithelial
CAGTTAGTCCATATGG-1	Fibroblasts
CAGTTCCAGTATCCTG-1	Epithelial
CAGTTCCGTCTCAGAT-1	Neural
CAGTTCCTCCTGTTAT-1	Fibroblasts
CAGTTCCTCGTCACCT-1	Fibroblasts
CATAAGCAGAGCCATG-1	Fibroblasts
CATAAGCAGAGGTCAC-1	Fibroblasts
CATAAGCCACGGTGCT-1	Muscle
CATAAGCGTCCTCATC-1	Fibroblasts
CATAAGCGTTATGACC-1	Epithelial
CATAAGCGTTTGGAGG-1	Epithelial
CATAAGCTCGCATGAT-1	Epithelial
CATACAGCAACACGTT-1	Epithelial
CATACAGGTCGCAACC-1	Endothelial
CATACAGGTGAGTAGC-1	Fibroblasts
CATACCCAGAGCGACT-1	Fibroblasts
CATACCCGTCGTTGGC-1	Immune
CATACCCTCGAGAAGC-1	Epithelial
CATACTTCAAGGCCTC-1	Myofibroblast_Mesothelium
CATACTTGTAACTAAG-1	Fibroblasts
CATACTTTCCATAAGC-1	Muscle
CATAGACGTACGGCAA-1	Neural
CATCAAGAGCATATGA-1	Muscle
CATCAAGCACTACGGC-1	Fibroblasts
CATCAAGCATGCGTGC-1	Epithelial
CATCAAGGTATGGTTC-1	Endothelial
CATCAAGTCATCTGTT-1	Fibroblasts
CATCAAGTCCCGAGAC-1	Fibroblasts
CATCCACCACGAGGAT-1	Fibroblasts
CATCCACCAGTATGAA-1	Pericytes
CATCCCAAGCTAATCC-1	Fibroblasts
CATCCCAAGTTTGTCG-1	Epithelial
CATCCCATCTACGCGG-1	Fibroblasts
CATCCGTAGGGTCTTT-1	Endothelial
CATCCGTAGTGGGAAA-1	Neural
CATCCGTTCCACAGCG-1	Fibroblasts
CATCGCTAGCCGGAAT-1	Myofibroblast_Mesothelium
CATCGCTAGCTCATAC-1	Muscle
CATCGCTAGGTTGGAC-1	Fibroblasts
CATCGCTAGTCTAACC-1	Fibroblasts
CATCGCTCAGTTCTAG-1	Epithelial
CATCGCTCATACTGTG-1	Pericytes
CATCGGGAGCGTTAGG-1	Fibroblasts
CATCGGGCACTTCAAG-1	Pericytes
CATCGGGGTCAGTCGC-1	Fibroblasts
CATCGGGTCGCTACGG-1	Fibroblasts
CATCGTCGTCGGCTAC-1	Fibroblasts
CATCGTCTCGATTGGT-1	Myofibroblast_Mesothelium
CATGAGTAGCGTGCCT-1	Epithelial
CATGAGTCAAATTGCC-1	Epithelial
CATGCAAAGTATTGCC-1	Pericytes
CATGCAACAAGAGGCT-1	Fibroblasts
CATGCAACACAATCTG-1	Epithelial
CATGCAACACCCAAGC-1	Epithelial
CATGCAACACTGATTG-1	Epithelial
CATGCAACAGGAATCG-1	Myofibroblast_Mesothelium
CATGCAAGTGTGGACA-1	Epithelial
CATGCCTAGAGGATGA-1	Myofibroblast_Mesothelium
CATGCCTGTAGATCCT-1	Myofibroblast_Mesothelium
CATGCCTGTAGGAAAG-1	Fibroblasts
CATGCCTTCCGTGTCT-1	Myofibroblast_Mesothelium
CATGCCTTCTCATGGA-1	Fibroblasts
CATGCGGAGGCAGGGA-1	Immune
CATGCGGCAGAATGTA-1	Epithelial
CATGCGGCATGGGTTT-1	Epithelial
CATGCGGGTTCGGCTG-1	Myofibroblast_Mesothelium
CATGCGGTCTTAAGGC-1	Endothelial
CATGCTCAGTAAAGCT-1	Myofibroblast_Mesothelium
CATGCTCCAAAGCTAA-1	Myofibroblast_Mesothelium
CATGCTCCAGAAATCA-1	Muscle
CATGCTCCATTCCTCG-1	Myofibroblast_Mesothelium
CATGGATAGATCGGTG-1	Fibroblasts
CATGGATGTTGTGCCG-1	Endothelial
CATGGATTCCCAGCGA-1	Epithelial
CATGGATTCTTCCCGA-1	Fibroblasts
CATGGTAAGTCTACCA-1	Endothelial
CATGGTACAACCGACC-1	Fibroblasts
CATGGTATCACTCACC-1	Myofibroblast_Mesothelium
CATTCATCACTCCCTA-1	Neural
CATTCATCATAGAAAC-1	Neural
CATTCATCATTCAGCA-1	Myofibroblast_Mesothelium
CATTCATCATTGCCTC-1	Fibroblasts
CATTCATGTTTCCATT-1	Fibroblasts
CATTCATTCATGAGTC-1	Fibroblasts
CATTCATTCTTACTGT-1	Fibroblasts
CATTCCGAGAGGATGA-1	Myofibroblast_Mesothelium
CATTCCGAGTGGCCTC-1	Epithelial
CATTCCGCATCTGGGC-1	Fibroblasts
CATTCCGGTCATAGTC-1	Epithelial
CATTCCGTCCTTACCG-1	Myofibroblast_Mesothelium
CATTCTAGTAGGTAGC-1	Fibroblasts
CATTCTATCTTCTGGC-1	Fibroblasts
CATTGAGGTCCGAAAG-1	Myofibroblast_Mesothelium
CATTGCCAGAAGCGCT-1	Fibroblasts
CATTGCCGTTTCGTGA-1	Fibroblasts
CATTGTTAGAGAGCCT-1	Pericytes
CATTGTTAGGATTACA-1	Immune
CATTGTTCACGGTCTG-1	Epithelial
CATTGTTCAGAATGTA-1	Fibroblasts
CATTGTTCAGAGCGTA-1	Fibroblasts
CATTGTTGTATTCTCT-1	Epithelial
CATTTCACAGAACCGA-1	Fibroblasts
CATTTCACAGATCCAT-1	Immune
CATTTCAGTATCACCA-1	Fibroblasts
CATTTCAGTCGTTATG-1	Endothelial
CATTTCAGTCTTCCGT-1	Epithelial
CATTTCAGTTGCCTAA-1	Muscle
CATTTCATCAATCTTC-1	Fibroblasts
CATTTCATCCAAATGC-1	Myofibroblast_Mesothelium
CCAAGCGCAATTGCTG-1	Myofibroblast_Mesothelium
CCAAGCGGTAATTGGA-1	Epithelial
CCAAGCGGTCTTGAAC-1	Muscle
CCAAGCGTCGCGAAGA-1	Fibroblasts
CCAAGCGTCGGCCAAC-1	Epithelial
CCAAGCGTCTTGGCTC-1	Epithelial
CCAATGAAGCCTCAGC-1	Epithelial
CCAATGACAAGTCCAT-1	Fibroblasts
CCAATGACACGCAAAG-1	Neural
CCAATTTAGAGGCCAT-1	Endothelial
CCAATTTAGCGTCTGC-1	Neural
CCAATTTAGTGCACAG-1	Epithelial
CCAATTTGTCCTCCTA-1	Endothelial
CCAATTTGTCGCTTAA-1	Epithelial
CCACAAACAAGTGGAC-1	Fibroblasts
CCACAAAGTACGATCT-1	Fibroblasts
CCACAAAGTACGCGTC-1	Neural
CCACAAAGTCCAGCGT-1	Pericytes
CCACAAATCTGTAACG-1	Immune
CCACAAATCTGTCTCG-1	Epithelial
CCACACTAGAAGTCTA-1	Epithelial
CCACACTAGACTGTTC-1	Muscle
CCACACTTCATGAAAG-1	Pericytes
CCACACTTCCTGGCTT-1	Myofibroblast_Mesothelium
CCACACTTCTGACCCT-1	Myofibroblast_Mesothelium
CCACCATAGATCGACG-1	Epithelial
CCACCATCAACGGTAG-1	Epithelial
CCACCATCATACCAGT-1	Immune
CCACCATGTCTCTCAC-1	Epithelial
CCACGAGAGACTTCCA-1	Epithelial
CCACGAGAGAGAGCCT-1	Epithelial
CCACGAGCAAGGCGTA-1	Epithelial
CCACGAGGTAAGACCG-1	Fibroblasts
CCACGAGGTCTGTGTA-1	Pericytes
CCACGAGGTGTATCCA-1	Fibroblasts
CCACGAGGTTCTGAGT-1	Epithelial
CCACGAGGTTGGGATG-1	Fibroblasts
CCACGAGTCGGAATTC-1	Epithelial
CCACGAGTCTATACTC-1	Myofibroblast_Mesothelium
CCACGAGTCTCAGTCC-1	Pericytes
CCACGAGTCTGACCCT-1	Endothelial
CCACGTTAGGAACATT-1	Myofibroblast_Mesothelium
CCACGTTAGTAGATCA-1	Myofibroblast_Mesothelium
CCACGTTAGTCTGCGC-1	Fibroblasts
CCACGTTCAGACTGCC-1	Neural
CCACGTTCATGTGACT-1	Epithelial
CCACTTGCACGATAGG-1	Neural
CCATAAGAGCCTGAGA-1	Epithelial
CCATAAGAGGGCCAAT-1	Fibroblasts
CCATAAGCAGCCATTA-1	Epithelial
CCATAAGGTAGCGCTC-1	Endothelial
CCATAAGTCGGTCGAC-1	Fibroblasts
CCATCACAGCTTTGTG-1	Fibroblasts
CCATCACAGGTCATCT-1	Neural
CCATCACCAATTGAAG-1	Fibroblasts
CCATCACGTGGTCAAG-1	Epithelial
CCATCACTCCCATTCG-1	Myofibroblast_Mesothelium
CCATCACTCCGTCACT-1	Immune
CCATCACTCCTGGGTG-1	Epithelial
CCCAACTCAAGCAATA-1	Endothelial
CCCAACTCAGAGTAAT-1	Epithelial
CCCAACTCAGTCACGC-1	Fibroblasts
CCCAACTCAGTCTTCC-1	Epithelial
CCCAACTGTAGCGCTC-1	Fibroblasts
CCCAACTGTCACTCGG-1	Epithelial
CCCAACTGTGGATACG-1	Fibroblasts
CCCAACTTCACAACCA-1	Fibroblasts
CCCAACTTCTGGCCTT-1	Endothelial
CCCATTGAGTGTGTTC-1	Epithelial
CCCATTGCAATGTTGC-1	Neural
CCCATTGCAGCGTGCT-1	Neural
CCCATTGCAGGGACTA-1	Fibroblasts
CCCATTGGTGGTAACG-1	Myofibroblast_Mesothelium
CCCATTGTCAAGAGGC-1	Myofibroblast_Mesothelium
CCCATTGTCGAGATGG-1	Neural
CCCATTGTCGTTAGAC-1	Epithelial
CCCGAAGGTCACGACC-1	Muscle
CCCGAAGGTTAAGACA-1	Neural
CCCGAAGTCAGCGCGT-1	Epithelial
CCCGGAAAGACTCATC-1	Fibroblasts
CCCGGAAAGGTCATTC-1	Fibroblasts
CCCGGAAAGTATGACA-1	Epithelial
CCCGGAACAAGTTCGT-1	Myofibroblast_Mesothelium
CCCGGAAGTGAGGATC-1	Epithelial
CCCTAACAGCCGGATA-1	Pericytes
CCCTAACGTACGATTC-1	Endothelial
CCCTAACGTGGTCTAT-1	Epithelial
CCCTAACTCTCAGAAC-1	Muscle
CCCTCAAAGCGCGTTC-1	Epithelial
CCCTCAACACACAGAG-1	Endothelial
CCCTCAACAGTCAACT-1	Myofibroblast_Mesothelium
CCCTCAACATAATGCC-1	Myofibroblast_Mesothelium
CCCTCAATCGTTAGTG-1	Fibroblasts
CCCTCTCAGGGATCAC-1	Epithelial
CCCTCTCAGGGCTAAC-1	Epithelial
CCCTCTCAGTTGCCCG-1	Fibroblasts
CCCTCTCGTTGCCATA-1	Epithelial
CCCTCTCTCACTGGTA-1	Epithelial
CCCTCTCTCAGACTGT-1	Fibroblasts
CCCTGATCACGATAGG-1	Epithelial
CCCTGATCAGGTGTTT-1	Myofibroblast_Mesothelium
CCCTGATGTGTTGAGG-1	Pericytes
CCCTGATTCCACACAA-1	Myofibroblast_Mesothelium
CCCTGATTCTCAGAAC-1	Endothelial
CCCTGATTCTTCACAT-1	Fibroblasts
CCCTTAGAGGACGCAT-1	Fibroblasts
CCCTTAGAGTCTAGCT-1	Epithelial
CCCTTAGCAAATCAGA-1	Fibroblasts
CCCTTAGCAAGAGGCT-1	Muscle
CCCTTAGCAGGAATCG-1	Endothelial
CCGAACGCACTCCTGT-1	Neural
CCGAACGCATCCTAAG-1	Epithelial
CCGATCTAGCAGGTCA-1	Epithelial
CCGATCTAGGTTGGAC-1	Fibroblasts
CCGATCTAGTCTAACC-1	Epithelial
CCGATCTCAATCACGT-1	Endothelial
CCGATCTCAGCGACCT-1	Epithelial
CCGATCTTCACGGGCT-1	Myofibroblast_Mesothelium
CCGATCTTCTTCTGTA-1	Pericytes
CCGATGGCAATACCTG-1	Fibroblasts
CCGATGGCAGTCAGAG-1	Fibroblasts
CCGATGGGTCGCTTGG-1	Pericytes
CCGATGGTCTGGCCGA-1	Fibroblasts
CCGCAAGAGATGGCGT-1	Endothelial
CCGCAAGCAGCGATTT-1	Epithelial
CCGCAAGGTATGCAAA-1	Endothelial
CCGCAAGTCTTCCAGC-1	Myofibroblast_Mesothelium
CCGGACAAGAGTTCGG-1	Pericytes
CCGGACAGTTGCTAGT-1	Epithelial
CCGGACATCCTGCCAT-1	Epithelial
CCGGGTAAGCCGAATG-1	Epithelial
CCGGGTACAGGTGTGA-1	Epithelial
CCGGGTAGTCAAGCGA-1	Epithelial
CCGGGTATCAACCTCC-1	Epithelial
CCGGGTATCCGGTAAT-1	Pericytes
CCGGTAGCAGAAGCGT-1	Epithelial
CCGGTAGCATACATCG-1	Muscle
CCGGTAGGTATATGGA-1	Neural
CCGGTAGTCAGACCTA-1	Pericytes
CCGGTAGTCAGTGCGC-1	Endothelial
CCGGTAGTCTCAAAGC-1	Fibroblasts
CCGGTAGTCTTTCTAG-1	Pericytes
CCGGTGACACTTGAAC-1	Fibroblasts
CCGGTGACATTCATCT-1	Fibroblasts
CCGGTGAGTGCGTGCT-1	Neural
CCGGTGATCACCGGGT-1	Muscle
CCGGTGATCCACCTCA-1	Fibroblasts
CCGGTGATCCGTATAG-1	Fibroblasts
CCGTAGGAGTGGACTG-1	Neural
CCGTAGGCAACCTAAC-1	Fibroblasts
CCGTAGGCACAAGCCC-1	Fibroblasts
CCGTAGGGTCGGTGAA-1	Epithelial
CCGTAGGGTGTAGTGG-1	Epithelial
CCGTAGGGTTAGGGAC-1	Myofibroblast_Mesothelium
CCGTAGGGTTCCGCAG-1	Fibroblasts
CCGTAGGTCTGTGCAA-1	Fibroblasts
CCGTGAGAGAGCCTGA-1	Epithelial
CCGTGAGGTGACCGAA-1	Fibroblasts
CCGTGAGGTTTGTTCT-1	Fibroblasts
CCGTTCACAACGGCTC-1	Fibroblasts
CCTAACCAGAGTGAAG-1	Endothelial
CCTAACCAGCGAGGAG-1	Epithelial
CCTAACCAGGTCTGGA-1	Epithelial
CCTAACCCACCCAATA-1	Fibroblasts
CCTAACCCAGAAGTTA-1	Fibroblasts
CCTAACCCATGGGATG-1	Epithelial
CCTAACCGTCCCGGTA-1	Neural
CCTAACCGTCGTCGGT-1	Epithelial
CCTAAGAAGTCATACC-1	Epithelial
CCTAAGACAAGTGTCT-1	Epithelial
CCTAAGACACATACGT-1	Myofibroblast_Mesothelium
CCTAAGACACCTGAAT-1	Pericytes
CCTAAGACATCATGAC-1	Immune
CCTAAGAGTACTGAGG-1	Epithelial
CCTAAGAGTTCTTAGG-1	Myofibroblast_Mesothelium
CCTAAGAGTTGGCCGT-1	Endothelial
CCTAAGATCAGCACCG-1	Myofibroblast_Mesothelium
CCTACGTCATCGATAC-1	Fibroblasts
CCTACGTGTACAGTCT-1	Myofibroblast_Mesothelium
CCTACGTGTCAACCTA-1	Epithelial
CCTACGTTCCGAGAAG-1	Epithelial
CCTATCGAGATGTTCC-1	Fibroblasts
CCTATCGAGATTCGAA-1	Immune
CCTATCGCACTGCGAC-1	Epithelial
CCTATCGGTCCATAGT-1	Fibroblasts
CCTATCGGTCGAATTC-1	Fibroblasts
CCTATCGTCATTGGTG-1	Epithelial
CCTCAACAGCCTCTCT-1	Epithelial
CCTCAACCAAATACAG-1	Endothelial
CCTCAACGTTTAGAGA-1	Fibroblasts
CCTCAACTCAAGAAAC-1	Myofibroblast_Mesothelium
CCTCAACTCACCCTTG-1	Fibroblasts
CCTCAACTCGTCCTCA-1	Myofibroblast_Mesothelium
CCTCACAAGATTAGTG-1	Neural
CCTCACACAATCGAAA-1	Endothelial
CCTCACAGTTAGGCTT-1	Fibroblasts
CCTCACATCGTACACA-1	Fibroblasts
CCTCACATCTTCGATT-1	Fibroblasts
CCTCAGTAGAACCGCA-1	Immune
CCTCAGTCAAAGACTA-1	Fibroblasts
CCTCAGTCAACACGAG-1	Epithelial
CCTCAGTCAGAGCGTA-1	Myofibroblast_Mesothelium
CCTCAGTGTGTACAGG-1	Epithelial
CCTCAGTGTTTAGTCG-1	Epithelial
CCTCAGTTCGCCAGAC-1	Epithelial
CCTCATGAGGAACGAA-1	Fibroblasts
CCTCATGAGGATTTCC-1	Myofibroblast_Mesothelium
CCTCATGCAATACGCT-1	Epithelial
CCTCATGCAGCAGTGA-1	Fibroblasts
CCTCATGGTTTCGTGA-1	Myofibroblast_Mesothelium
CCTCCAAAGAATCCCT-1	Fibroblasts
CCTCCAACATCTCAAG-1	Pericytes
CCTCCAAGTCAGTTTG-1	Endothelial
CCTCCTCAGCCTGAGA-1	Immune
CCTCCTCCACGGCCAT-1	Epithelial
CCTCCTCGTGTGAGCA-1	Myofibroblast_Mesothelium
CCTCTAGAGCAACAGC-1	Endothelial
CCTCTAGCAATTGTGC-1	Epithelial
CCTCTAGGTAAGGCTG-1	Epithelial
CCTCTAGTCCATTGTT-1	Fibroblasts
CCTCTCCAGATTGTGA-1	Endothelial
CCTCTCCAGTATGAAC-1	Epithelial
CCTCTCCCAACGTAAA-1	Fibroblasts
CCTCTCCCACAGAGCA-1	Fibroblasts
CCTCTCCGTGCACATT-1	Epithelial
CCTCTCCTCCATCAGA-1	Epithelial
CCTGCATGTAGATCGG-1	Neural
CCTGCATGTCGTATGT-1	Neural
CCTGCATTCCCGTTCA-1	Epithelial
CCTGCATTCGTTCGCT-1	Pericytes
CCTGTTGAGCAGTCTT-1	Fibroblasts
CCTGTTGCAGATGCGA-1	Myofibroblast_Mesothelium
CCTGTTGGTGCCTATA-1	Fibroblasts
CCTGTTGGTTACCGTA-1	Pericytes
CCTTCAGAGAACCGCA-1	Myofibroblast_Mesothelium
CCTTCAGCAAGCGATG-1	Endothelial
CCTTCAGCAGTTTCGA-1	Epithelial
CCTTCAGGTAGCTTTG-1	Fibroblasts
CCTTCAGTCCGAACGC-1	Fibroblasts
CCTTCAGTCTCCCTAG-1	Fibroblasts
CCTTCAGTCTCGCCTA-1	Fibroblasts
CCTTGTGCAAACACGG-1	Endothelial
CCTTGTGCACTGTCCT-1	Endothelial
CCTTGTGCATCACAGT-1	Epithelial
CCTTGTGTCCTCCACA-1	Fibroblasts
CCTTTGGAGAACGTGC-1	Endothelial
CCTTTGGAGGATATGT-1	Pericytes
CCTTTGGCACAGTATC-1	Neural
CCTTTGGGTTTGTTGG-1	Fibroblasts
CCTTTGGTCCAGTGTA-1	Fibroblasts
CCTTTGGTCGTTAGAC-1	Endothelial
CGAAGGACATAGGTTC-1	Fibroblasts
CGAAGGAGTACGCTAT-1	Endothelial
CGAAGGAGTGGTAACG-1	Endothelial
CGAAGGATCCTGGTCT-1	Myofibroblast_Mesothelium
CGAAGTTCAGACTCTA-1	Endothelial
CGAAGTTCAGCCGGTT-1	Epithelial
CGAAGTTGTCACTAGT-1	Neural
CGAAGTTGTGGCTTAT-1	Fibroblasts
CGAAGTTGTTGACGGA-1	Myofibroblast_Mesothelium
CGAAGTTTCATTGCCC-1	Pericytes
CGAAGTTTCTCTAGGA-1	Immune
CGAATTGAGAAGTCTA-1	Endothelial
CGAATTGCAGAGCTAG-1	Endothelial
CGAATTGGTGTAAACA-1	Fibroblasts
CGAATTGTCACAATGC-1	Myofibroblast_Mesothelium
CGAATTGTCTCGCTTG-1	Pericytes
CGACAGCCATACTTTC-1	Fibroblasts
CGACAGCGTTCCAAAC-1	Fibroblasts
CGACAGCTCCTTCAGC-1	Epithelial
CGAGAAGCAGATCCAT-1	Fibroblasts
CGAGAAGGTCTACATG-1	Pericytes
CGAGAAGGTGCATGTT-1	Fibroblasts
CGAGAAGTCTAGATCG-1	Epithelial
CGAGAAGTCTGCGATA-1	Epithelial
CGAGGAAAGATACAGT-1	Neural
CGAGGAAAGCAGCGAT-1	Fibroblasts
CGAGGAAGTACGAGCA-1	Muscle
CGAGGAAGTCAACCAT-1	Pericytes
CGAGGAATCTCCCAAC-1	Epithelial
CGAGGCTAGCATGTTC-1	Myofibroblast_Mesothelium
CGAGGCTAGTCATGGG-1	Epithelial
CGAGGCTAGTTCCAGT-1	Pericytes
CGAGGCTCAACGAGGT-1	Myofibroblast_Mesothelium
CGAGGCTCAACGGTAG-1	Fibroblasts
CGAGGCTCAGTCAGAG-1	Fibroblasts
CGAGGCTGTACCTAAC-1	Epithelial
CGAGGCTTCTATTCGT-1	Myofibroblast_Mesothelium
CGAGGCTTCTTGAACG-1	Epithelial
CGAGTGCAGGGACTGT-1	Fibroblasts
CGAGTGCCAAAGTGTA-1	Fibroblasts
CGAGTGCGTCGGCACT-1	Neural
CGAGTGCTCAATGCAC-1	Epithelial
CGAGTGCTCCTTCGAC-1	Fibroblasts
CGAGTTAAGAGTAACT-1	Epithelial
CGAGTTACATAAGCAA-1	Neural
CGAGTTACATTACGGT-1	Pericytes
CGATCGGAGACAACAT-1	Endothelial
CGATCGGAGGCTAACG-1	Epithelial
CGATCGGAGTTAGAAC-1	Fibroblasts
CGATCGGCAAACTGCT-1	Fibroblasts
CGATCGGCAACAAGAT-1	Fibroblasts
CGATCGGTCCACGGAC-1	Myofibroblast_Mesothelium
CGATCGGTCGACATCA-1	Fibroblasts
CGATGCGAGATTGCGG-1	Endothelial
CGATGCGAGGGTAATT-1	Epithelial
CGATGCGCACATGTTG-1	Fibroblasts
CGATGCGGTTGTAGCT-1	Myofibroblast_Mesothelium
CGATGCGTCAGATGCT-1	Fibroblasts
CGATGGCCAACGTAAA-1	Neural
CGATGGCCATACAGAA-1	Neural
CGATGGCGTAGGAAAG-1	Fibroblasts
CGATGGCGTCTTGCGG-1	Epithelial
CGATGGCGTGAGTTTC-1	Fibroblasts
CGATGGCTCCAAGCCG-1	Epithelial
CGATGGCTCCAATCTT-1	Fibroblasts
CGATGGCTCGGTCGAC-1	Epithelial
CGCAGGTAGCAAATCA-1	Muscle
CGCAGGTCAACCGTGC-1	Fibroblasts
CGCAGGTTCGTTCATT-1	Fibroblasts
CGCATAAAGCCAGAGT-1	Fibroblasts
CGCATAAAGGTAGCAC-1	Myofibroblast_Mesothelium
CGCATAAAGGTTCTAC-1	Neural
CGCATAACATCCTGTC-1	Myofibroblast_Mesothelium
CGCATAAGTCCCTCAT-1	Fibroblasts
CGCATAATCTGGGCAC-1	Epithelial
CGCATGGCACACCGCA-1	Fibroblasts
CGCATGGGTCCAACGC-1	Fibroblasts
CGCATGGGTTACCTGA-1	Myofibroblast_Mesothelium
CGCCAGAAGCCATGCC-1	Epithelial
CGCCAGACAGAACTCT-1	Endothelial
CGCCAGAGTCGACTTA-1	Epithelial
CGCCAGATCCTAAGTG-1	Pericytes
CGCCATTCAGCAAGAC-1	Epithelial
CGCCATTGTGTCCATA-1	Fibroblasts
CGCCATTTCGACATCA-1	Epithelial
CGCCATTTCGCATAGT-1	Fibroblasts
CGCCATTTCTGCGTCT-1	Fibroblasts
CGCGTGAAGCGCCTTG-1	Myofibroblast_Mesothelium
CGCGTGAAGCGCTTCG-1	Immune
CGCGTGACATGTACGT-1	Myofibroblast_Mesothelium
CGCGTGACATTAGGCT-1	Neural
CGCGTGATCACGGGAA-1	Myofibroblast_Mesothelium
CGCGTGATCGGTGAAG-1	Epithelial
CGGAACCAGACGCTCC-1	Epithelial
CGGAACCAGCGTACAG-1	Myofibroblast_Mesothelium
CGGAATTTCCCGTGAG-1	Myofibroblast_Mesothelium
CGGACACCATGCCATA-1	Endothelial
CGGACACTCAAGTCTG-1	Epithelial
CGGAGAAAGACTCTTG-1	Muscle
CGGAGAAAGGCTAACG-1	Immune
CGGAGAAGTCGGAAAC-1	Myofibroblast_Mesothelium
CGGAGAAGTTGCTCCT-1	Epithelial
CGGCAGTAGAGATTCA-1	Pericytes
CGGCAGTAGGTTCCAT-1	Fibroblasts
CGGCAGTAGTCAATCC-1	Fibroblasts
CGGCAGTGTCATAGTC-1	Fibroblasts
CGGCAGTGTTACCCTC-1	Fibroblasts
CGGGACTAGGGTGAAA-1	Fibroblasts
CGGGACTCAAGGCGTA-1	Immune
CGGGACTCAGCTTCGG-1	Pericytes
CGGGACTCATTAAGCC-1	Fibroblasts
CGGGACTGTACAGTTC-1	Fibroblasts
CGGGACTTCCAGCAAT-1	Endothelial
CGGGACTTCCGAGTGC-1	Epithelial
CGGGACTTCTCGCAGG-1	Pericytes
CGGGCATAGTCAGGGT-1	Fibroblasts
CGGGCATCACTTTAGG-1	Fibroblasts
CGGGTCAAGACCATTC-1	Epithelial
CGGGTCAAGCTGACCC-1	Myofibroblast_Mesothelium
CGGGTCAAGTGTAGTA-1	Pericytes
CGGGTCACATCGTCCT-1	Epithelial
CGGGTCATCGCATTAG-1	Pericytes
CGGGTGTAGCGGTAGT-1	Pericytes
CGGGTGTAGCGGTATG-1	Fibroblasts
CGGGTGTAGTAGCCAG-1	Epithelial
CGGGTGTCACGATTCA-1	Fibroblasts
CGGGTGTGTCTTGTCC-1	Epithelial
CGGGTGTTCAGTCCGG-1	Epithelial
CGGGTGTTCTACCTTA-1	Epithelial
CGGTCAGAGGTATTGA-1	Epithelial
CGGTCAGGTCTCGACG-1	Myofibroblast_Mesothelium
CGGTCAGTCGGAGTAG-1	Neural
CGGTCAGTCTGTGTGA-1	Endothelial
CGTAAGTAGGGCAACT-1	Fibroblasts
CGTAAGTCAATAAGGT-1	Endothelial
CGTAAGTTCCCAGCGA-1	Fibroblasts
CGTAAGTTCCTCTAGC-1	Fibroblasts
CGTAAGTTCTCTTGCG-1	Fibroblasts
CGTAATGAGATACTGA-1	Epithelial
CGTAATGAGCTTTGTG-1	Epithelial
CGTAATGCAAATACAG-1	Pericytes
CGTAATGCAGGAATCG-1	Muscle
CGTAGTAAGAAGTCTA-1	Fibroblasts
CGTAGTAGTACCGTCG-1	Epithelial
CGTCAAAAGAGTCGAC-1	Fibroblasts
CGTCAAACAAGGGTCA-1	Fibroblasts
CGTCAAACAGAGGACT-1	Fibroblasts
CGTCAAACAGAGGCTA-1	Fibroblasts
CGTCAAACATCTAACG-1	Fibroblasts
CGTCAAAGTCCAAGAG-1	Neural
CGTCAAAGTTGCAAGG-1	Fibroblasts
CGTCAAATCGCTAGCG-1	Fibroblasts
CGTCCATAGAGAAGGT-1	Pericytes
CGTCCATAGGCATCGA-1	Fibroblasts
CGTCCATGTCCGAAAG-1	Fibroblasts
CGTCCATGTTCAGTAC-1	Fibroblasts
CGTCCATTCGCTTACC-1	Epithelial
CGTGAATAGTAGAATC-1	Pericytes
CGTGAATAGTTGCTGT-1	Fibroblasts
CGTGAATCAATTGTGC-1	Epithelial
CGTGAATTCAGTGTTG-1	Fibroblasts
CGTGAATTCTTGGCTC-1	Fibroblasts
CGTGATAAGGGAGGAC-1	Fibroblasts
CGTGATACATGCCGCA-1	Epithelial
CGTGATATCCTCTAGC-1	Fibroblasts
CGTGCTTCAAGCGCTC-1	Myofibroblast_Mesothelium
CGTGCTTTCGACGCGT-1	Epithelial
CGTGTCTAGACAACAT-1	Fibroblasts
CGTGTCTAGTTTCTTC-1	Pericytes
CGTGTCTCAACAAGTA-1	Neural
CGTGTCTCACCTCTAC-1	Fibroblasts
CGTGTCTCAGTCACGC-1	Epithelial
CGTGTCTGTCACTCAA-1	Pericytes
CGTGTCTGTCGCACGT-1	Epithelial
CGTGTCTGTGACAGCA-1	Fibroblasts
CGTGTCTGTTGCGGAA-1	Epithelial
CGTTAGAAGGTTTACC-1	Muscle
CGTTAGACATAACCCA-1	Epithelial
CGTTAGAGTTGCTGAT-1	Epithelial
CGTTCTGAGAGTCAAT-1	Epithelial
CGTTCTGAGGGCAGTT-1	Myofibroblast_Mesothelium
CGTTCTGAGGGCGAGA-1	Fibroblasts
CGTTCTGAGGTACCTT-1	Immune
CGTTCTGCAACATACC-1	Myofibroblast_Mesothelium
CGTTCTGCAACTCCCT-1	Fibroblasts
CGTTCTGCAGCTCGGT-1	Fibroblasts
CGTTCTGGTAAGCAAT-1	Immune
CGTTCTGGTACTGACT-1	Epithelial
CGTTCTGGTGACGTCC-1	Fibroblasts
CGTTGGGAGATACCAA-1	Neural
CGTTGGGAGGCTAACG-1	Epithelial
CGTTGGGCAACACGAG-1	Endothelial
CGTTGGGCAACGATTC-1	Epithelial
CGTTGGGCAGTTGAAA-1	Fibroblasts
CGTTGGGGTGCTGATT-1	Pericytes
CGTTGGGTCATTGCCC-1	Myofibroblast_Mesothelium
CTAACCCAGAGGCCAT-1	Fibroblasts
CTAACCCAGGATACCG-1	Endothelial
CTAACCCCAGACACCC-1	Fibroblasts
CTAACCCCAGACCAGA-1	Fibroblasts
CTAACCCCAGAGTTCT-1	Myofibroblast_Mesothelium
CTAACCCTCTCTTCAA-1	Fibroblasts
CTAACTTAGCATTTGC-1	Epithelial
CTAACTTCAAGACGAC-1	Fibroblasts
CTAACTTCACAGCTTA-1	Epithelial
CTAACTTCACGTTGGC-1	Neural
CTAACTTCATGCTGCG-1	Fibroblasts
CTAACTTGTGTGGACA-1	Endothelial
CTAAGTGCAGAAGCTG-1	Myofibroblast_Mesothelium
CTAAGTGCAGGATGAC-1	Epithelial
CTAAGTGCATGAATCC-1	Epithelial
CTAAGTGGTGTGATGG-1	Endothelial
CTAAGTGGTTCTCGTC-1	Epithelial
CTAAGTGTCAGCTTGA-1	Fibroblasts
CTAAGTGTCGTCCTCA-1	Epithelial
CTACAGAAGCGATTCT-1	Endothelial
CTACAGAAGGTGCCTC-1	Muscle
CTACAGACAAGCTACT-1	Pericytes
CTACAGACACGCTTAA-1	Endothelial
CTACAGAGTAGCTTGT-1	Pericytes
CTACAGAGTGCCCGTA-1	Fibroblasts
CTACATTAGGTCATTC-1	Pericytes
CTACATTCAAATACGA-1	Myofibroblast_Mesothelium
CTACATTCAAGCGATG-1	Pericytes
CTACATTCATCCTATT-1	Epithelial
CTACATTCATGACTGT-1	Fibroblasts
CTACATTGTTATCCAG-1	Neural
CTACATTTCCGAGATT-1	Immune
CTACATTTCGACCTAA-1	Fibroblasts
CTACATTTCGCACGAC-1	Pericytes
CTACATTTCGGAGTAG-1	Epithelial
CTACCCAAGACTTAAG-1	Fibroblasts
CTACCCAAGCCTCGTG-1	Epithelial
CTACCCAAGGTTAAAC-1	Epithelial
CTACCCAGTATTTCTC-1	Myofibroblast_Mesothelium
CTACCCAGTTAGGCTT-1	Fibroblasts
CTACCCATCGTTGCCT-1	Myofibroblast_Mesothelium
CTACCTGCACATTGTG-1	Fibroblasts
CTACCTGCAGATCCAT-1	Myofibroblast_Mesothelium
CTACCTGCAGGACATG-1	Myofibroblast_Mesothelium
CTACCTGCAGTAACAA-1	Epithelial
CTACCTGGTCAACATC-1	Fibroblasts
CTACGGGAGAGTGTGC-1	Muscle
CTACGGGCAAACTCTG-1	Epithelial
CTACGGGCAGAGTAAT-1	Epithelial
CTACGGGTCACGTAGT-1	Myofibroblast_Mesothelium
CTACTATAGTAAATGC-1	Neural
CTACTATCACACCGAC-1	Epithelial
CTACTATGTGGACTGA-1	Fibroblasts
CTACTATGTTTGGCTA-1	Fibroblasts
CTACTATTCATAGCAC-1	Fibroblasts
CTACTATTCCCGAGAC-1	Epithelial
CTACTATTCGACGCGT-1	Epithelial
CTAGACAAGACAGCGT-1	Fibroblasts
CTAGACACATCAGCAT-1	Fibroblasts
CTAGACATCAATCTTC-1	Epithelial
CTAGGTATCAACGCTA-1	Pericytes
CTAGGTATCCGAGAAG-1	Endothelial
CTAGGTATCTCATGCC-1	Fibroblasts
CTATAGGCAATGGCAG-1	Fibroblasts
CTATAGGCAGCGTTGC-1	Myofibroblast_Mesothelium
CTATAGGGTACAGAGC-1	Neural
CTATAGGGTAGGGTAC-1	Epithelial
CTATCCGAGGCAGTCA-1	Immune
CTATCCGAGGCGTTAG-1	Myofibroblast_Mesothelium
CTATCCGAGTGAGTGC-1	Epithelial
CTATCCGCACAACGCC-1	Fibroblasts
CTATCCGCACGACCTG-1	Pericytes
CTATCCGTCGTCTCAC-1	Epithelial
CTATCCGTCTAAGCGT-1	Fibroblasts
CTATCTAGTTCGTACA-1	Fibroblasts
CTATCTATCCAACCGG-1	Epithelial
CTATCTATCTGGCTGG-1	Epithelial
CTCAACCAGCCTGAGA-1	Endothelial
CTCAACCTCGGTCAGC-1	Epithelial
CTCAAGAAGGCGACAT-1	Fibroblasts
CTCAAGAAGTTGGGAC-1	Endothelial
CTCAAGACACTAGAGG-1	Fibroblasts
CTCAAGAGTGAGCTCC-1	Neural
CTCAAGATCGCGCTGA-1	Myofibroblast_Mesothelium
CTCAATTAGATCGCTT-1	Endothelial
CTCAATTAGCCTTTCC-1	Fibroblasts
CTCAATTAGGAGGGTG-1	Endothelial
CTCAATTCAGTTCCAA-1	Fibroblasts
CTCAATTGTCTAGATC-1	Fibroblasts
CTCAATTGTTACCCAA-1	Endothelial
CTCACTGAGACCGTTT-1	Neural
CTCACTGAGAGTATAC-1	Fibroblasts
CTCACTGAGTGGTTCT-1	Myofibroblast_Mesothelium
CTCACTGCAAGCAGGT-1	Epithelial
CTCACTGCACAATGCT-1	Myofibroblast_Mesothelium
CTCACTGCACATACGT-1	Epithelial
CTCACTGTCACTCGAA-1	Pericytes
CTCACTGTCGACACCG-1	Neural
CTCAGAAAGCTGACCC-1	Epithelial
CTCAGAAGTTCTAACG-1	Epithelial
CTCAGGGAGCCTGTGC-1	Fibroblasts
CTCAGTCCAGAGTGTG-1	Epithelial
CTCATCGCAGAATGTA-1	Fibroblasts
CTCATCGTCCTAGAGT-1	Myofibroblast_Mesothelium
CTCATGCAGCAAGCCA-1	Fibroblasts
CTCATGCGTAATGCTC-1	Epithelial
CTCATGCGTAGTACGG-1	Fibroblasts
CTCATGCGTGGATCGA-1	Myofibroblast_Mesothelium
CTCATGCGTTCTATCT-1	Epithelial
CTCATGCTCAAGCCAT-1	Epithelial
CTCATTAAGTAGTGCG-1	Fibroblasts
CTCATTAAGTTTGGCT-1	Neural
CTCATTAGTAGTTCCA-1	Muscle
CTCATTAGTCCGCAGT-1	Fibroblasts
CTCATTAGTCTCTCCA-1	Epithelial
CTCATTAGTCTTGAGT-1	Epithelial
CTCCAACGTGCCTATA-1	Epithelial
CTCCAACTCCTTACCG-1	Epithelial
CTCCAACTCTTTCTAG-1	Epithelial
CTCCACAAGGGCTGAT-1	Myofibroblast_Mesothelium
CTCCACAGTCAACATC-1	Fibroblasts
CTCCACATCCCTAGGG-1	Epithelial
CTCCATGAGCATCCTA-1	Fibroblasts
CTCCATGAGCGTCTGC-1	Fibroblasts
CTCCATGCACATTACG-1	Myofibroblast_Mesothelium
CTCCATGCAGCTTTGA-1	Fibroblasts
CTCCATGTCACCTGTC-1	Neural
CTCCATGTCGAATGCT-1	Muscle
CTCCCAAAGACCATTC-1	Pericytes
CTCCCAAAGTGATGGC-1	Pericytes
CTCCCAAAGTGCGACA-1	Endothelial
CTCCCAACACGACAGA-1	Pericytes
CTCCCAATCACCCTGT-1	Fibroblasts
CTCCCTCAGGTGCTGA-1	Fibroblasts
CTCCCTCCACTTACAG-1	Epithelial
CTCCCTCCAGCAGTCC-1	Epithelial
CTCCCTCCAGGCGTTC-1	Epithelial
CTCCCTCGTGTGAGCA-1	Epithelial
CTCCGATAGAGCTGCA-1	Pericytes
CTCCGATAGCGACCCT-1	Epithelial
CTCCGATCAGTCGGTC-1	Fibroblasts
CTCCGATGTCACTAGT-1	Endothelial
CTCCGATGTTGGGAAC-1	Epithelial
CTCCGATTCATTTGCT-1	Epithelial
CTCCGATTCCGTGGTG-1	Neural
CTCCTCCAGTGTACCT-1	Epithelial
CTCCTCCCAGCAGGAT-1	Fibroblasts
CTCCTCCGTATCCCAA-1	Epithelial
CTCCTCCGTCAGGAGT-1	Pericytes
CTCCTCCTCCCTATTA-1	Epithelial
CTCCTTTAGAATACAC-1	Epithelial
CTCCTTTAGATAACAC-1	Epithelial
CTCCTTTAGATAGTCA-1	Epithelial
CTCCTTTAGGAAAGAC-1	Fibroblasts
CTCCTTTCAATAGTCC-1	Epithelial
CTCCTTTCACGTAACT-1	Epithelial
CTCCTTTGTCACCCTT-1	Fibroblasts
CTCCTTTGTGTCTAAC-1	Endothelial
CTCCTTTGTTATGTGC-1	Fibroblasts
CTCGAGGCAGACACAG-1	Endothelial
CTCGAGGGTATCGTGT-1	Pericytes
CTCGAGGGTCCTGTTC-1	Epithelial
CTCTCAGAGGTCCCGT-1	Fibroblasts
CTCTCAGAGGTTATAG-1	Epithelial
CTCTCAGCACCTGCAG-1	Fibroblasts
CTCTCAGCAGTCGCAC-1	Epithelial
CTCTCAGGTGCACATT-1	Fibroblasts
CTCTCAGGTGTCCAAT-1	Fibroblasts
CTCTCAGGTTATAGCC-1	Immune
CTCTCAGTCATAGACC-1	Epithelial
CTCTCAGTCATCGGGC-1	Fibroblasts
CTCTCAGTCCTAGCGG-1	Pericytes
CTCTCAGTCTACGCAA-1	Fibroblasts
CTCTCGACAGACAATA-1	Fibroblasts
CTCTCGAGTACCAATC-1	Neural
CTCTCGATCCTATTGT-1	Fibroblasts
CTCTCGATCTCTAAGG-1	Pericytes
CTCTGGTAGACAACTA-1	Fibroblasts
CTCTGGTCACATACTG-1	Fibroblasts
CTCTGGTCACATGTTG-1	Pericytes
CTCTGGTCATCACAGT-1	Epithelial
CTGAATGCACTGTTCC-1	Pericytes
CTGAATGCAGCTCATA-1	Epithelial
CTGAATGGTGTTATCG-1	Fibroblasts
CTGAATGTCATACAGC-1	Pericytes
CTGAATGTCCTGTACC-1	Myofibroblast_Mesothelium
CTGAGCGAGCATCCCG-1	Myofibroblast_Mesothelium
CTGAGCGAGGAAGTCC-1	Fibroblasts
CTGAGCGGTGTGATGG-1	Neural
CTGAGCGGTTGTGTAC-1	Pericytes
CTGAGGCCAAGTCCAT-1	Fibroblasts
CTGAGGCCACACCTTC-1	Epithelial
CTGAGGCCAGGTGTGA-1	Epithelial
CTGATCCAGCGTCTCG-1	Epithelial
CTGATCCCAAACACGG-1	Fibroblasts
CTGATCCGTAAGCAAT-1	Fibroblasts
CTGATCCTCAAACGTC-1	Fibroblasts
CTGATCCTCTACTCAT-1	Epithelial
CTGCAGGCACACAGAG-1	Epithelial
CTGCAGGCACGGGTAA-1	Epithelial
CTGCAGGGTTCGGGTC-1	Epithelial
CTGCAGGTCGGTCGAC-1	Immune
CTGCAGGTCTCTCGAC-1	Epithelial
CTGCATCAGAAGTCAT-1	Fibroblasts
CTGCATCCAAGCGCTC-1	Epithelial
CTGCATCCAGCGTACC-1	Fibroblasts
CTGCATCGTAACCCGC-1	Pericytes
CTGCATCTCATCACCC-1	Myofibroblast_Mesothelium
CTGCATCTCGGACTGC-1	Pericytes
CTGCATCTCTCGGCTT-1	Myofibroblast_Mesothelium
CTGCCATAGAGTGTGC-1	Endothelial
CTGCCATAGATACAGT-1	Neural
CTGCCATAGCGCCCAT-1	Myofibroblast_Mesothelium
CTGCCATAGGAACGTC-1	Epithelial
CTGCCATAGTCATGCT-1	Muscle
CTGCCATAGTTGCCTA-1	Fibroblasts
CTGCCATCACAGAGAC-1	Endothelial
CTGCCATCACAGCTTA-1	Myofibroblast_Mesothelium
CTGCCATGTTTAGAGA-1	Epithelial
CTGCCTAAGAGCTGCA-1	Epithelial
CTGCCTAAGTGATGGC-1	Fibroblasts
CTGCCTAGTATTGGCT-1	Epithelial
CTGCCTAGTCAACACT-1	Fibroblasts
CTGCCTATCACACGAT-1	Pericytes
CTGCCTATCGTAACTG-1	Fibroblasts
CTGCGAGAGCTGTTCA-1	Neural
CTGCGAGCACAAATAG-1	Epithelial
CTGCGAGCATGACTGT-1	Myofibroblast_Mesothelium
CTGCGAGCATGCCGAC-1	Fibroblasts
CTGCGAGGTCACTCAA-1	Fibroblasts
CTGCGAGGTGAGTTTC-1	Fibroblasts
CTGCTCAAGAGAGTGA-1	Pericytes
CTGCTCAAGCTACTGT-1	Fibroblasts
CTGCTCAAGTATGTAG-1	Epithelial
CTGCTCACACTACACA-1	Myofibroblast_Mesothelium
CTGCTCAGTCCACAGC-1	Neural
CTGCTCAGTTCCTTGC-1	Endothelial
CTGCTCATCATAAGGA-1	Myofibroblast_Mesothelium
CTGCTCATCCCGTGTT-1	Epithelial
CTGGACGCAACAGAGC-1	Muscle
CTGGACGCAATCTCGA-1	Muscle
CTGGCAGAGATCCCAT-1	Epithelial
CTGGCAGAGCATTTCG-1	Epithelial
CTGGCAGAGCGCCTTG-1	Myofibroblast_Mesothelium
CTGGCAGCATTACTCT-1	Pericytes
CTGGCAGGTCACTCGG-1	Pericytes
CTGGCAGGTCCAAAGG-1	Myofibroblast_Mesothelium
CTGGCAGGTTAAGGGC-1	Epithelial
CTGGCAGTCCACTGGG-1	Myofibroblast_Mesothelium
CTGGTCTGTTCATCTT-1	Epithelial
CTGGTCTGTTGCCTAA-1	Neural
CTGGTCTTCAGCTAGT-1	Fibroblasts
CTGTACCAGACCTGGA-1	Epithelial
CTGTACCAGCCTCATA-1	Fibroblasts
CTGTACCGTAAGCAAT-1	Epithelial
CTGTACCGTACTTCCC-1	Endothelial
CTGTACCGTTACGATC-1	Myofibroblast_Mesothelium
CTGTACCTCGCGTGAC-1	Fibroblasts
CTGTACCTCTACTTCA-1	Fibroblasts
CTGTAGAAGTAACAGT-1	Myofibroblast_Mesothelium
CTGTAGACAAATAAGC-1	Epithelial
CTGTAGACAATAGGAT-1	Epithelial
CTGTAGAGTAGCTTTG-1	Fibroblasts
CTGTAGATCTCGCCTA-1	Myofibroblast_Mesothelium
CTGTATTAGCTCACTA-1	Fibroblasts
CTGTATTTCAGTAGGG-1	Immune
CTGTATTTCCGAGTGC-1	Epithelial
CTGTCGTAGACTACCT-1	Immune
CTGTCGTGTTGACTGT-1	Epithelial
CTGTCGTTCAAAGGTA-1	Epithelial
CTGTCGTTCTCGACCT-1	Epithelial
CTGTGAAAGTGGATAT-1	Fibroblasts
CTGTGAACAAGCGATG-1	Muscle
CTGTGAACAGAGAATT-1	Epithelial
CTGTGAAGTGGCACTC-1	Immune
CTGTGAAGTTGGTAGG-1	Epithelial
CTGTGAATCCTATTGT-1	Myofibroblast_Mesothelium
CTGTGAATCTCGCCTA-1	Epithelial
CTGTGGGAGAAGTATC-1	Epithelial
CTGTGGGCAGGCATTT-1	Fibroblasts
CTGTGGGGTTTGGAGG-1	Muscle
CTGTGGGTCCAATGCA-1	Epithelial
CTTACCGAGACGAAGA-1	Endothelial
CTTACCGAGGTGCGAT-1	Muscle
CTTACCGCAACACTAC-1	Fibroblasts
CTTACCGCACGATAGG-1	Pericytes
CTTACCGGTAACGATA-1	Neural
CTTACCGGTATTCTCT-1	Fibroblasts
CTTACCGGTTATCTTC-1	Fibroblasts
CTTACCGTCGCTTTAT-1	Fibroblasts
CTTAGGAAGAAGTCCG-1	Pericytes
CTTAGGAAGCATTTGC-1	Epithelial
CTTAGGAAGGCTCAAG-1	Endothelial
CTTAGGACACGTACTA-1	Myofibroblast_Mesothelium
CTTAGGAGTGAGGAAA-1	Fibroblasts
CTTAGGATCATTATCC-1	Fibroblasts
CTTAGGATCCGCAAAT-1	Endothelial
CTTCAATGTTCGAACT-1	Myofibroblast_Mesothelium
CTTCAATGTTCTCTAT-1	Fibroblasts
CTTCAATTCGTGCAGC-1	Myofibroblast_Mesothelium
CTTCAATTCTTAGGAC-1	Myofibroblast_Mesothelium
CTTCCGACAACAGCCC-1	Epithelial
CTTCCGATCAGTCCGG-1	Fibroblasts
CTTCCGATCGAAACAA-1	Epithelial
CTTCCTTAGTGATGGC-1	Epithelial
CTTCCTTAGTGGTGGT-1	Fibroblasts
CTTCCTTCAAGTGTCT-1	Myofibroblast_Mesothelium
CTTCCTTTCAAGCGTT-1	Epithelial
CTTCCTTTCCCTCTTT-1	Fibroblasts
CTTCCTTTCTGAGCAT-1	Epithelial
CTTCGGTAGCTGAGCA-1	Endothelial
CTTCGGTCAACAACAA-1	Epithelial
CTTCGGTCAAGGCCTC-1	Epithelial
CTTCGGTGTATGCTTG-1	Fibroblasts
CTTCGGTGTGACCTGC-1	Epithelial
CTTCGGTTCGTTAGAC-1	Neural
CTTCGGTTCTAGTGTG-1	Endothelial
CTTCTAAAGATAACAC-1	Epithelial
CTTCTAAAGGTGCATG-1	Fibroblasts
CTTCTAAGTAGTGGCA-1	Epithelial
CTTCTAATCACAATGC-1	Epithelial
CTTCTCTCAAAGGAGA-1	Epithelial
CTTCTCTCATCGGCCA-1	Fibroblasts
CTTCTCTTCTGGCCAG-1	Pericytes
CTTGAGAAGGCTGGAT-1	Myofibroblast_Mesothelium
CTTGAGAGTCATCCCT-1	Epithelial
CTTGAGAGTTACCTGA-1	Myofibroblast_Mesothelium
CTTGATTAGCGAGAAA-1	Fibroblasts
CTTGATTAGTTGGCTT-1	Myofibroblast_Mesothelium
CTTGATTCACAAATGA-1	Neural
CTTGATTTCGAAGGAC-1	Epithelial
CTTGATTTCGCAGTTA-1	Neural
CTTTCAAAGACGATAT-1	Fibroblasts
CTTTCAAAGGCCTTGC-1	Fibroblasts
CTTTCAAAGGTCGACA-1	Pericytes
CTTTCAAAGTTGCCTA-1	Epithelial
CTTTCAACAGGCAATG-1	Myofibroblast_Mesothelium
CTTTCGGAGCAGGGAG-1	Fibroblasts
CTTTCGGCAGTTGCGC-1	Epithelial
CTTTCGGGTTGTAAAG-1	Muscle
CTTTCGGTCATTGCTT-1	Epithelial
CTTTCGGTCGCTGTCT-1	Fibroblasts
GAAACCTCACATTCTT-1	Epithelial
GAAACCTCATCCCGTT-1	Fibroblasts
GAAACCTGTACCTTCC-1	Neural
GAAACCTGTATCAGCT-1	Neural
GAAACCTGTCTCCCTA-1	Pericytes
GAAACCTTCGCCGTGA-1	Fibroblasts
GAAATGAAGGGATCAC-1	Fibroblasts
GAAATGAAGTCGTTAC-1	Fibroblasts
GAAATGACAACCAATC-1	Pericytes
GAAATGACACAAGCTT-1	Epithelial
GAAATGACACCCGTAG-1	Myofibroblast_Mesothelium
GAACACTAGACGACTG-1	Epithelial
GAACACTAGGCTGAAC-1	Myofibroblast_Mesothelium
GAACACTCAGGAGGAG-1	Fibroblasts
GAACACTCAGGTGTGA-1	Fibroblasts
GAACACTCATGCCGCA-1	Fibroblasts
GAACACTGTGAATGAT-1	Fibroblasts
GAACACTTCGTTGCCT-1	Epithelial
GAACGTTAGGCTTAGG-1	Fibroblasts
GAACGTTAGGGCAATC-1	Myofibroblast_Mesothelium
GAACGTTGTGGCCACT-1	Immune
GAACGTTTCCCATAGA-1	Epithelial
GAACGTTTCCGGGACT-1	Neural
GAACTGTCACATACTG-1	Epithelial
GAACTGTCATTGAGCT-1	Fibroblasts
GAACTGTGTGAGATCG-1	Fibroblasts
GAACTGTTCTGTAACG-1	Fibroblasts
GAAGAATAGAACGTGC-1	Epithelial
GAAGAATAGCAGTAAT-1	Myofibroblast_Mesothelium
GAAGAATAGTCGTCTA-1	Muscle
GAAGAATAGTGACACG-1	Neural
GAAGAATGTGGAAATT-1	Pericytes
GAAGAATTCAAATGCC-1	Fibroblasts
GAAGAATTCGCCGAAC-1	Epithelial
GAAGCCCCAGTTGTCA-1	Fibroblasts
GAAGCCCCATCGGCCA-1	Fibroblasts
GAAGCCCGTATGCTAC-1	Epithelial
GAAGCCCGTGGTGATG-1	Myofibroblast_Mesothelium
GAAGCCCTCTCCGCAT-1	Pericytes
GAAGCCCTCTCCTGTG-1	Epithelial
GAAGCGAGTTGGTACT-1	Fibroblasts
GAAGGACCAGTTGCGC-1	Epithelial
GAAGGACTCAGTGTGT-1	Neural
GAAGGGTAGATGCGAC-1	Endothelial
GAAGGGTCATACAGAA-1	Epithelial
GAAGGGTTCCCAGCGA-1	Epithelial
GAAGGGTTCTCTCGCA-1	Endothelial
GAAGTAAAGCAGTACG-1	Pericytes
GAAGTAACAACGATTC-1	Fibroblasts
GAAGTAACAGGTGTTT-1	Fibroblasts
GAAGTAATCGACACTA-1	Fibroblasts
GAATAGACAAATTGCC-1	Fibroblasts
GAATAGAGTGGGATTG-1	Epithelial
GAATAGAGTTTCTTAC-1	Endothelial
GAATAGATCCTACAAG-1	Epithelial
GAATCACGTACCAATC-1	Epithelial
GAATCACGTCATACCA-1	Epithelial
GAATCGTCAAGTATCC-1	Epithelial
GAATCGTCAATGCAAA-1	Fibroblasts
GAATCGTCACCCTCTA-1	Epithelial
GACACGCAGCACCAGA-1	Muscle
GACACGCAGGCCCAAA-1	Myofibroblast_Mesothelium
GACACGCCAAATGATG-1	Neural
GACACGCGTAAGATTG-1	Neural
GACAGCCCAACCAATC-1	Pericytes
GACAGCCGTAACTGCT-1	Pericytes
GACAGCCGTTCTGACA-1	Pericytes
GACAGCCTCACTTGGA-1	Epithelial
GACAGCCTCCTTGAAG-1	Immune
GACATCAAGCCTGCCA-1	Epithelial
GACATCAAGCTAGCCC-1	Immune
GACATCACAATACCTG-1	Muscle
GACATCAGTCACTTCC-1	Pericytes
GACATCAGTGGTCCCA-1	Endothelial
GACATCAGTGTCCTAA-1	Fibroblasts
GACATCATCATCACAG-1	Fibroblasts
GACATCATCTAGTCAG-1	Myofibroblast_Mesothelium
GACATCATCTCGTCAC-1	Myofibroblast_Mesothelium
GACATCATCTGCATAG-1	Fibroblasts
GACCAATAGCATCGAG-1	Fibroblasts
GACCAATAGTGCGCTC-1	Fibroblasts
GACCAATCAAGGGCAT-1	Fibroblasts
GACCAATGTATGTCCA-1	Myofibroblast_Mesothelium
GACCAATGTCAGCTTA-1	Fibroblasts
GACCAATTCACCTGTC-1	Epithelial
GACCCAGAGGAGGTTC-1	Endothelial
GACCCAGCAAGTAGTA-1	Myofibroblast_Mesothelium
GACCCAGCATTCGGGC-1	Neural
GACCCAGTCGAGTGAG-1	Epithelial
GACCCTTCAACGTAAA-1	Fibroblasts
GACCCTTCAGACATCT-1	Fibroblasts
GACCCTTCATACCAGT-1	Epithelial
GACCCTTGTGATTGGG-1	Fibroblasts
GACCCTTGTGTATTCG-1	Epithelial
GACCCTTTCAAGCCCG-1	Muscle
GACCGTGAGGCATTTC-1	Pericytes
GACCGTGAGTCGGGAT-1	Neural
GACCGTGCAGTTAGAA-1	Fibroblasts
GACCGTGGTAGAGACC-1	Neural
GACCGTGGTGTAACGG-1	Fibroblasts
GACCGTGTCATCCCGT-1	Epithelial
GACCTTCAGGGACAGG-1	Myofibroblast_Mesothelium
GACCTTCAGTTTCGAC-1	Endothelial
GACCTTCCAACGGTAG-1	Fibroblasts
GACCTTCCACCATTCC-1	Epithelial
GACCTTCCACGCGCTA-1	Neural
GACCTTCCATAAGCGG-1	Fibroblasts
GACCTTCGTGACGTCC-1	Neural
GACCTTCGTTCGAAGG-1	Pericytes
GACCTTCTCAACCTTT-1	Neural
GACCTTCTCGGTCTAA-1	Myofibroblast_Mesothelium
GACGCTGAGACGAGCT-1	Fibroblasts
GACGCTGAGCACTCCG-1	Fibroblasts
GACGCTGAGCGACTGA-1	Myofibroblast_Mesothelium
GACGCTGCAGACCCGT-1	Fibroblasts
GACGCTGCATTGAAAG-1	Pericytes
GACGCTGGTCATCAGT-1	Fibroblasts
GACGCTGGTCTTTATC-1	Fibroblasts
GACGTTAAGAATTGTG-1	Immune
GACGTTACAGTAGGAC-1	Pericytes
GACGTTACATAACTCG-1	Immune
GACGTTAGTAGCTGCC-1	Muscle
GACGTTAGTGATATAG-1	Fibroblasts
GACGTTATCAAAGGAT-1	Myofibroblast_Mesothelium
GACGTTATCCGTGCGA-1	Neural
GACGTTATCCGTGGTG-1	Myofibroblast_Mesothelium
GACGTTATCTTCCCAG-1	Epithelial
GACTATGAGGTGATCG-1	Fibroblasts
GACTATGCACAATTCG-1	Myofibroblast_Mesothelium
GACTATGTCACAAGAA-1	Neural
GACTCAAAGAATACAC-1	Neural
GACTCAAAGCACTCTA-1	Fibroblasts
GACTCAACAAGAGTGC-1	Neural
GACTCAAGTAGAATAC-1	Fibroblasts
GACTCAAGTCGTTATG-1	Fibroblasts
GACTCAAGTTGGGAAC-1	Epithelial
GACTCAATCGTCACCT-1	Fibroblasts
GACTCTCAGCGATTCT-1	Myofibroblast_Mesothelium
GACTCTCCAACCACGC-1	Muscle
GACTCTCCAACCCTAA-1	Endothelial
GACTCTCGTCGCGTCA-1	Fibroblasts
GACTCTCGTGATAGAT-1	Myofibroblast_Mesothelium
GACTCTCTCTCTCGAC-1	Immune
GACTGATAGTGCCCGT-1	Neural
GACTGATAGTTTGAGA-1	Neural
GACTGATCACCCAAGC-1	Fibroblasts
GACTGATGTGGTTCTA-1	Endothelial
GACTGATTCCTCTGCA-1	Fibroblasts
GACTGATTCGACTCCT-1	Myofibroblast_Mesothelium
GACTTCCAGACATAGT-1	Epithelial
GACTTCCAGCGGTATG-1	Epithelial
GACTTCCAGGAAACGA-1	Fibroblasts
GACTTCCAGTCCCGAC-1	Pericytes
GACTTCCAGTTTCTTC-1	Muscle
GACTTCCCATTGTAGC-1	Pericytes
GACTTCCGTATGCGGA-1	Pericytes
GACTTCCGTTCGGCCA-1	Epithelial
GACTTCCGTTCTTGCC-1	Epithelial
GACTTCCTCTGTCGTC-1	Epithelial
GAGAAATAGGAACTAT-1	Epithelial
GAGAAATCAACCCTAA-1	Epithelial
GAGAAATCACATCCCT-1	Epithelial
GAGAAATCAGAGACTG-1	Fibroblasts
GAGAAATGTAGGTCAG-1	Myofibroblast_Mesothelium
GAGAAATGTATCACCA-1	Endothelial
GAGACCCAGCACCTGC-1	Fibroblasts
GAGACCCAGGAGATAG-1	Fibroblasts
GAGACCCCACAAACGG-1	Muscle
GAGACCCCACCTCTGT-1	Myofibroblast_Mesothelium
GAGACCCCAGAACCGA-1	Epithelial
GAGACCCGTCGTTGGC-1	Neural
GAGACCCGTTTGGCTA-1	Pericytes
GAGACCCTCTGTTGGA-1	Fibroblasts
GAGACTTAGCCAGTAG-1	Fibroblasts
GAGACTTGTCCACACG-1	Immune
GAGACTTTCCTGCCAT-1	Muscle
GAGACTTTCGTAGGAG-1	Epithelial
GAGAGGTAGTCGAGGT-1	Epithelial
GAGAGGTCACGGAAGT-1	Fibroblasts
GAGAGGTGTAGCGCTC-1	Fibroblasts
GAGAGGTGTGGAAATT-1	Myofibroblast_Mesothelium
GAGAGGTTCATCTGTT-1	Neural
GAGATGGCACAAAGCG-1	Epithelial
GAGATGGCAGATACTC-1	Endothelial
GAGATGGTCCGCGGAT-1	Myofibroblast_Mesothelium
GAGCCTGGTGGTCTTA-1	Muscle
GAGCCTGTCCAACTAG-1	Myofibroblast_Mesothelium
GAGCCTGTCTGTGCGG-1	Fibroblasts
GAGCTGCCAGACTGCC-1	Epithelial
GAGCTGCGTACCACGC-1	Pericytes
GAGCTGCGTCTTTCAT-1	Epithelial
GAGCTGCTCCACCCTA-1	Epithelial
GAGCTGCTCGTAATGC-1	Immune
GAGGCAAAGCACAAAT-1	Epithelial
GAGGCAAAGGCTGGAT-1	Epithelial
GAGGCAAAGGTGTGAC-1	Epithelial
GAGGCAACACCCATAA-1	Fibroblasts
GAGGCAAGTATGGTTC-1	Immune
GAGGCAAGTGGACCTC-1	Pericytes
GAGGCAATCAGCGCAC-1	Epithelial
GAGGCAATCGATACAC-1	Endothelial
GAGGCCTAGCACCGAA-1	Epithelial
GAGGCCTAGCTTGTGT-1	Pericytes
GAGGCCTAGGTAGCAC-1	Fibroblasts
GAGGCCTAGTGAATAC-1	Epithelial
GAGGCCTGTTGCCATA-1	Endothelial
GAGGCCTTCTCCAATT-1	Neural
GAGGCCTTCTTTGATC-1	Myofibroblast_Mesothelium
GAGGGATAGCTTAGTC-1	Neural
GAGGGATCAAGCCTGC-1	Pericytes
GAGGGATGTAGCACGA-1	Pericytes
GAGGGATGTATACAGA-1	Neural
GAGGGATGTCGTACAT-1	Fibroblasts
GAGGGATTCAGTGCGC-1	Epithelial
GAGGGTAGTACTGTTG-1	Myofibroblast_Mesothelium
GAGGGTAGTATCGTGT-1	Epithelial
GAGGGTAGTCAAAGTA-1	Fibroblasts
GAGTCATGTGTGATGG-1	Epithelial
GAGTCTAAGGTACTGG-1	Endothelial
GAGTCTACACCTCTAC-1	Epithelial
GAGTCTAGTGTGTACT-1	Endothelial
GAGTCTATCCCTCAAC-1	Epithelial
GAGTCTATCGCAATTG-1	Epithelial
GAGTCTATCGTAACTG-1	Epithelial
GAGTGAGAGCCTATTG-1	Epithelial
GAGTGAGAGCTAGAGC-1	Pericytes
GAGTGAGAGTGCACTT-1	Fibroblasts
GAGTGAGCACAGCATT-1	Myofibroblast_Mesothelium
GAGTGAGCAGTGTGGA-1	Fibroblasts
GAGTGAGCATCGTCCT-1	Fibroblasts
GAGTGAGGTGTAAATG-1	Endothelial
GAGTGAGGTTGAATCC-1	Myofibroblast_Mesothelium
GAGTGAGTCCTACAAG-1	Neural
GAGTTACAGGTTCCGC-1	Epithelial
GAGTTACCAGTGTGGA-1	Neural
GAGTTACGTAGAATGT-1	Fibroblasts
GAGTTACGTTCAAGTC-1	Myofibroblast_Mesothelium
GAGTTACTCAAGGTGG-1	Epithelial
GAGTTGTCAATACCTG-1	Endothelial
GAGTTGTGTGAGCTCC-1	Epithelial
GAGTTGTTCCACGGAC-1	Fibroblasts
GAGTTGTTCGGCCTTT-1	Fibroblasts
GAGTTGTTCTTGATTC-1	Epithelial
GAGTTTGGTCCATAGT-1	Epithelial
GAGTTTGTCGATCCCT-1	Myofibroblast_Mesothelium
GATAGAAAGGCTGGAT-1	Fibroblasts
GATAGAAAGGGCCAAT-1	Neural
GATAGAACAAGATGGC-1	Neural
GATAGAACATCGCTGG-1	Epithelial
GATAGAAGTGCTGATT-1	Endothelial
GATAGAAGTGGACTGA-1	Muscle
GATAGAATCACCATGA-1	Epithelial
GATAGAATCCTTCACG-1	Fibroblasts
GATAGAATCTACACAG-1	Epithelial
GATAGCTAGACCTCAT-1	Epithelial
GATAGCTAGGCTCACC-1	Fibroblasts
GATAGCTCATTACTCT-1	Fibroblasts
GATAGCTGTTAAGTCC-1	Epithelial
GATAGCTTCCATAGAC-1	Epithelial
GATCACAAGCGCCCAT-1	Pericytes
GATCACAAGCTCGTGC-1	Myofibroblast_Mesothelium
GATCACACATGACTTG-1	Immune
GATCACAGTCAACCAT-1	Endothelial
GATCACATCCGTCACT-1	Neural
GATCACATCCGTGGCA-1	Fibroblasts
GATCAGTAGCACCCAC-1	Epithelial
GATCAGTAGGATCACG-1	Endothelial
GATCAGTCAAGAATAC-1	Fibroblasts
GATCAGTGTTGTGGAG-1	Epithelial
GATCAGTTCGTGGCGT-1	Fibroblasts
GATCATGCATCGGCCA-1	Fibroblasts
GATCATGGTGCTCCGA-1	Immune
GATCATGGTGTCCGTG-1	Fibroblasts
GATCATGTCCGTCAAA-1	Epithelial
GATCATGTCCTTATCA-1	Fibroblasts
GATCATGTCTGCATAG-1	Epithelial
GATCCCTAGACTGTTC-1	Endothelial
GATCCCTAGCATCTTG-1	Fibroblasts
GATCCCTCAACTTGCA-1	Epithelial
GATCCCTGTACTAACC-1	Endothelial
GATCCCTGTTCCTAAG-1	Fibroblasts
GATCCCTGTTGTATGC-1	Fibroblasts
GATCCCTTCTGTGTGA-1	Epithelial
GATCGTACAATGTTGC-1	Fibroblasts
GATCGTACAGATAAAC-1	Endothelial
GATCGTACATCTGGGC-1	Epithelial
GATCGTAGTGAATTGA-1	Myofibroblast_Mesothelium
GATGACTAGTCCCAAT-1	Fibroblasts
GATGACTCACTAGTAC-1	Neural
GATGACTCAGGTTCGC-1	Fibroblasts
GATGACTGTCCTGTCT-1	Muscle
GATGAGGAGCTGCCTG-1	Fibroblasts
GATGAGGAGTCTGTAC-1	Endothelial
GATGAGGGTACCGTCG-1	Pericytes
GATGAGGGTATCGTGT-1	Fibroblasts
GATGAGGTCTTCCCGA-1	Fibroblasts
GATGATCAGAGGCCAT-1	Fibroblasts
GATGATCCAAGTAGTA-1	Fibroblasts
GATGATCCACCCTAAA-1	Epithelial
GATGATCCAGTCGCAC-1	Fibroblasts
GATGATCGTAGAGGAA-1	Fibroblasts
GATGATCGTGTTCATG-1	Immune
GATGCTAAGTGCGCTC-1	Epithelial
GATGCTACAAGCCTGC-1	Pericytes
GATGCTACACAGAGAC-1	Myofibroblast_Mesothelium
GATGCTACAGGCTTGC-1	Fibroblasts
GATGCTAGTAGCGTTT-1	Myofibroblast_Mesothelium
GATGCTAGTATCCCAA-1	Fibroblasts
GATGCTAGTGGAACCA-1	Myofibroblast_Mesothelium
GATGCTAGTGTCCACG-1	Endothelial
GATGCTATCAAGTCGT-1	Neural
GATGGAGAGTCGAAAT-1	Endothelial
GATGGAGCATGTAACC-1	Neural
GATGGAGTCAGCTCTC-1	Neural
GATGGAGTCATGGCCG-1	Fibroblasts
GATGGAGTCGTACCTC-1	Fibroblasts
GATGGAGTCTGCCTGT-1	Fibroblasts
GATGTTGAGAGTATAC-1	Fibroblasts
GATGTTGCACATGTTG-1	Epithelial
GATGTTGCAGACCAGA-1	Fibroblasts
GATGTTGTCAGCTTCC-1	Neural
GATTCGAAGGCGTTGA-1	Epithelial
GATTCGACAGAGCTAG-1	Epithelial
GATTCTTTCCACCTCA-1	Endothelial
GATTGGTAGCGGTAGT-1	Immune
GATTGGTCACAGTATC-1	Endothelial
GATTGGTGTCCGTTTC-1	Myofibroblast_Mesothelium
GATTGGTGTGCCCACA-1	Epithelial
GATTGGTGTGTTAACC-1	Muscle
GATTTCTCACAACGAG-1	Fibroblasts
GATTTCTCACATAGCT-1	Fibroblasts
GATTTCTGTAGCTGAG-1	Fibroblasts
GATTTCTGTCTGTGAT-1	Endothelial
GATTTCTTCTAGGCCG-1	Epithelial
GCAACATAGAGTCAAT-1	Myofibroblast_Mesothelium
GCAACATAGATGGCGT-1	Epithelial
GCAACATAGCGAGTAC-1	Fibroblasts
GCAACATAGGCACAAC-1	Fibroblasts
GCAACATAGGTTACCT-1	Fibroblasts
GCAACATCAGACCAAG-1	Fibroblasts
GCAACATCAGCTCATA-1	Fibroblasts
GCAACATGTGTAGTGG-1	Epithelial
GCAACATTCACCCATC-1	Epithelial
GCAACCGAGTGAGCCA-1	Myofibroblast_Mesothelium
GCAACCGCAAATAAGC-1	Endothelial
GCAACCGCAAGAATGT-1	Epithelial
GCAACCGCATGAGAAT-1	Neural
GCAACCGGTTGTTGAC-1	Fibroblasts
GCACATAAGGTCACCC-1	Fibroblasts
GCACATAAGTAACGTA-1	Epithelial
GCACATAAGTAGTCAA-1	Epithelial
GCACATAAGTCGAGGT-1	Myofibroblast_Mesothelium
GCACATACAGACATCT-1	Epithelial
GCACATACAGAGTTCT-1	Pericytes
GCACATACAGTTAAAG-1	Pericytes
GCACATAGTCCGATCG-1	Pericytes
GCACATAGTCGAACAG-1	Fibroblasts
GCACATAGTTGCTCAA-1	Epithelial
GCACATATCAAGATAG-1	Epithelial
GCACATATCAGCGCAC-1	Fibroblasts
GCACATATCGACGACC-1	Fibroblasts
GCACGGTAGGTCGACA-1	Epithelial
GCACGGTCAACGGCCT-1	Myofibroblast_Mesothelium
GCACGGTCAGCAGTTT-1	Endothelial
GCACGGTGTACGAGTG-1	Myofibroblast_Mesothelium
GCACGGTTCCTCTAGC-1	Myofibroblast_Mesothelium
GCACGGTTCGCCTATC-1	Muscle
GCACGGTTCTCTATAC-1	Muscle
GCACGTGAGCTGGCCT-1	Epithelial
GCACGTGAGTCCCGGT-1	Epithelial
GCACGTGCACAATGAA-1	Myofibroblast_Mesothelium
GCACGTGCAGCTATTG-1	Myofibroblast_Mesothelium
GCACGTGTCGGAATTC-1	Endothelial
GCACTAAAGACCATGG-1	Fibroblasts
GCACTAAAGCTCTGTA-1	Pericytes
GCACTAACACACGGAA-1	Immune
GCACTAACATCGTCCT-1	Fibroblasts
GCACTAACATTGTAGC-1	Fibroblasts
GCACTAAGTACAAGTA-1	Myofibroblast_Mesothelium
GCACTAAGTCAGTCTA-1	Pericytes
GCAGCCAAGGCACTCC-1	Neural
GCAGCCACAAAGGAGA-1	Fibroblasts
GCAGCCAGTCAACCTA-1	Epithelial
GCAGCCATCCTGTAGA-1	Muscle
GCAGCTGAGTAGATCA-1	Pericytes
GCAGCTGCACTGGATT-1	Fibroblasts
GCAGCTGCAGCTCATA-1	Fibroblasts
GCAGCTGCATTCACAG-1	Fibroblasts
GCAGCTGGTAACGTTC-1	Epithelial
GCAGCTGGTAGGTCAG-1	Epithelial
GCAGCTGGTGAACTAA-1	Fibroblasts
GCAGCTGGTGCGGTAA-1	Fibroblasts
GCAGCTGTCATCGCAA-1	Fibroblasts
GCAGCTGTCGACTCCT-1	Fibroblasts
GCAGCTGTCGCTTACC-1	Myofibroblast_Mesothelium
GCAGCTGTCTGCGAGC-1	Muscle
GCAGGCTCACGCCACA-1	Epithelial
GCAGGCTGTACTGCCG-1	Epithelial
GCAGGCTGTCATCTAG-1	Epithelial
GCAGGCTTCAAGGACG-1	Epithelial
GCAGGCTTCATGCATG-1	Fibroblasts
GCAGTTAGTACAGTTC-1	Fibroblasts
GCAGTTATCCCGAACG-1	Myofibroblast_Mesothelium
GCATCGGCACAGCGCT-1	Fibroblasts
GCATCTCGTAATGCGG-1	Myofibroblast_Mesothelium
GCATCTCGTGCTTATG-1	Fibroblasts
GCATCTCTCTAAGAAG-1	Fibroblasts
GCATGATAGCCTGACC-1	Myofibroblast_Mesothelium
GCATGATAGCGACATG-1	Epithelial
GCATGATGTCTACGTA-1	Epithelial
GCATGATTCTGTCCGT-1	Myofibroblast_Mesothelium
GCATTAGCAGCTTTGA-1	Epithelial
GCATTAGGTTCCGCAG-1	Pericytes
GCATTAGTCGTCAAAC-1	Epithelial
GCATTAGTCGTTATCT-1	Myofibroblast_Mesothelium
GCATTAGTCTCAAAGC-1	Epithelial
GCCAACGAGACTACCT-1	Epithelial
GCCAACGCAGATCCTA-1	Pericytes
GCCAACGTCAGCTAGT-1	Endothelial
GCCAACGTCCCATTTA-1	Myofibroblast_Mesothelium
GCCAACGTCCTACACC-1	Epithelial
GCCAGCAAGAAGAACG-1	Epithelial
GCCAGCAGTCCTCAGG-1	Fibroblasts
GCCAGCAGTTGTAAAG-1	Endothelial
GCCAGCATCGCCAATA-1	Epithelial
GCCAGGTAGAGATCGC-1	Fibroblasts
GCCAGGTGTGTTAGCT-1	Fibroblasts
GCCAGGTTCAATGCAC-1	Pericytes
GCCAGGTTCAGCACCG-1	Neural
GCCAGTGAGTGTGTTC-1	Epithelial
GCCAGTGCAAATCGTC-1	Epithelial
GCCAGTGGTCTTGAGT-1	Fibroblasts
GCCAGTGTCTGAATCG-1	Fibroblasts
GCCATGGAGCCAGTAG-1	Fibroblasts
GCCATGGGTCACGCTG-1	Muscle
GCCATGGTCCCAAGTA-1	Muscle
GCCATTCTCCGGTAGC-1	Muscle
GCCATTCTCGGTAGAG-1	Myofibroblast_Mesothelium
GCCCAGAAGCGCCATC-1	Endothelial
GCCCAGAAGTACGTCT-1	Fibroblasts
GCCCAGAAGTAGCAAT-1	Epithelial
GCCCAGAAGTTGCTGT-1	Fibroblasts
GCCCAGACAAGTATCC-1	Myofibroblast_Mesothelium
GCCCAGAGTAAGGCTG-1	Neural
GCCCAGAGTATACCCA-1	Epithelial
GCCCAGAGTGAGTTGG-1	Myofibroblast_Mesothelium
GCCCAGAGTGCTTATG-1	Myofibroblast_Mesothelium
GCCCAGATCATTACCT-1	Endothelial
GCCCGAAAGCGCAATG-1	Muscle
GCCCGAAAGCTGAAGC-1	Myofibroblast_Mesothelium
GCCCGAACAATGACCT-1	Epithelial
GCCCGAAGTACTAACC-1	Endothelial
GCCCGAATCTACCTTA-1	Epithelial
GCCGATGAGAATTGTG-1	Fibroblasts
GCCGATGAGAGCAGTC-1	Fibroblasts
GCCGATGAGGTTGACG-1	Neural
GCCGATGAGTCATGCT-1	Fibroblasts
GCCGATGAGTTGCTCA-1	Neural
GCCGATGCAATCTCGA-1	Epithelial
GCCGATGCACGCTGAC-1	Epithelial
GCCGATGCATGGAAGC-1	Epithelial
GCCGATGGTACCAGAG-1	Pericytes
GCCGTGAGTAAGATCA-1	Epithelial
GCCGTGAGTGGACTAG-1	Epithelial
GCCGTGAGTTGGTACT-1	Epithelial
GCCGTGATCCCTTGTG-1	Myofibroblast_Mesothelium
GCCGTGATCGTAGAGG-1	Pericytes
GCCTGTTGTACTAAGA-1	Endothelial
GCCTGTTGTGACCGTC-1	Epithelial
GCCTGTTTCAACACGT-1	Epithelial
GCCTGTTTCGATGGAG-1	Epithelial
GCGAGAAAGAAGCGCT-1	Fibroblasts
GCGAGAAAGCAAGGAA-1	Pericytes
GCGATCGAGCCATGCC-1	Myofibroblast_Mesothelium
GCGATCGGTGCTCGTG-1	Fibroblasts
GCGATCGGTTCGTACA-1	Epithelial
GCGGAAAAGTTAGAAC-1	Neural
GCGGAAATCCATACAG-1	Myofibroblast_Mesothelium
GCGGATCAGGTTCATC-1	Pericytes
GCGGATCCACAACGCC-1	Epithelial
GCGGATCCACCAGGTC-1	Epithelial
GCGGATCTCCCTCTTT-1	Epithelial
GCGTGCAAGACTACGG-1	Endothelial
GCGTGCACACTCCCTA-1	Myofibroblast_Mesothelium
GCGTGCACATCCGAAT-1	Neural
GCGTGCAGTCATCCGG-1	Pericytes
GCGTGCATCATCGGGC-1	Epithelial
GCGTGCATCATTTGGG-1	Neural
GCGTTTCGTCCGCAGT-1	Muscle
GCTACAAAGTCACTGT-1	Myofibroblast_Mesothelium
GCTACAAAGTTTCTTC-1	Epithelial
GCTACAATCCAACACA-1	Fibroblasts
GCTACCTAGAAACACT-1	Endothelial
GCTACCTCACGTCATA-1	Epithelial
GCTACCTGTAGTACGG-1	Epithelial
GCTACCTGTTTGTGGT-1	Pericytes
GCTACCTTCATTGTTC-1	Fibroblasts
GCTCAAAAGGAAACGA-1	Epithelial
GCTCAAACACCAGTAT-1	Fibroblasts
GCTCAAAGTAACTGCT-1	Fibroblasts
GCTCAAAGTAGGCAGT-1	Myofibroblast_Mesothelium
GCTCAAAGTGATACAA-1	Fibroblasts
GCTCAAATCATTTCCA-1	Endothelial
GCTGAATAGCGTTGTT-1	Immune
GCTGAATAGTACTGGG-1	Endothelial
GCTGAATCAAACACGG-1	Epithelial
GCTGAATCAAACCGGA-1	Epithelial
GCTGAATCAACACACT-1	Epithelial
GCTGAATCATGTAACC-1	Epithelial
GCTGAATGTCGCATCG-1	Epithelial
GCTGAATTCGTAGCTA-1	Muscle
GCTGCAGTCATTATCC-1	Myofibroblast_Mesothelium
GCTGCAGTCTATCGGA-1	Myofibroblast_Mesothelium
GCTGGGTCAATACCCA-1	Epithelial
GCTGGGTCACGAGAAC-1	Neural
GCTGGGTGTATGCTAC-1	Fibroblasts
GCTGGGTGTTAGGGAC-1	Fibroblasts
GCTGGGTTCCTGCCAT-1	Endothelial
GCTTCACAGCATACTC-1	Fibroblasts
GCTTCACAGCTGTGCC-1	Fibroblasts
GCTTCACCAAAGACTA-1	Immune
GCTTCACCAGTCGAGA-1	Epithelial
GCTTCACGTCTGCCTT-1	Fibroblasts
GCTTCACTCCGCTTAC-1	Epithelial
GCTTGGGAGCTACTAC-1	Epithelial
GCTTGGGTCGCGCTGA-1	Muscle
GCTTTCGAGAGCATCG-1	Pericytes
GCTTTCGAGTTGTCAC-1	Neural
GCTTTCGGTACCGGAA-1	Pericytes
GGAACCCAGGGCGAGA-1	Epithelial
GGAACCCGTAGGTGCA-1	Epithelial
GGAACCCTCCAATGCA-1	Epithelial
GGAAGTGCACAATGAA-1	Epithelial
GGAAGTGCAGAGAAAG-1	Myofibroblast_Mesothelium
GGAAGTGGTGCCTTTC-1	Neural
GGAAGTGGTTTAGAGA-1	Epithelial
GGAAGTGTCTCTGAGA-1	Pericytes
GGAATCTAGATCACCT-1	Fibroblasts
GGAATCTCAGACTGCC-1	Myofibroblast_Mesothelium
GGAATCTCATCTAACG-1	Fibroblasts
GGAATCTCATCTTCGC-1	Fibroblasts
GGAATCTTCTCTTGCG-1	Immune
GGAATGGAGCAAATCA-1	Muscle
GGAATGGCATATCGGT-1	Fibroblasts
GGAATGGGTACCTTCC-1	Fibroblasts
GGAATGGGTGATTCTG-1	Endothelial
GGAATGGTCAATCCAG-1	Myofibroblast_Mesothelium
GGAATGGTCTCCTGAC-1	Fibroblasts
GGAATGGTCTTCGTAT-1	Endothelial
GGACGTCAGGTCTTTG-1	Fibroblasts
GGACGTCCAAGCGCAA-1	Epithelial
GGACGTCCACGTTCGG-1	Immune
GGACGTCCAGTGGGTA-1	Myofibroblast_Mesothelium
GGACGTCGTCAAGCCC-1	Pericytes
GGACGTCGTCACCCTT-1	Epithelial
GGACGTCTCAGTCATG-1	Epithelial
GGACGTCTCATAGACC-1	Myofibroblast_Mesothelium
GGACGTCTCCAGGACC-1	Fibroblasts
GGAGAACAGGATTCAA-1	Pericytes
GGAGAACCAAGAGTGC-1	Fibroblasts
GGAGAACCAGCCGGTT-1	Myofibroblast_Mesothelium
GGAGAACTCAACCGAT-1	Endothelial
GGAGAACTCAGTGATC-1	Myofibroblast_Mesothelium
GGAGATGAGTCGAAGC-1	Epithelial
GGAGATGGTCGTTTCC-1	Epithelial
GGAGATGGTTTACGAC-1	Myofibroblast_Mesothelium
GGAGATGTCATGGGAG-1	Endothelial
GGAGATGTCCACGGGT-1	Myofibroblast_Mesothelium
GGAGCAAGTTTACTGG-1	Fibroblasts
GGAGCAATCTTGGTGA-1	Fibroblasts
GGAGGATAGCATGCGA-1	Muscle
GGAGGATAGCTTAAGA-1	Endothelial
GGAGGATCACACCGCA-1	Myofibroblast_Mesothelium
GGAGGATGTTTGGAGG-1	Epithelial
GGAGGATTCACCTCTG-1	Myofibroblast_Mesothelium
GGAGGTAAGGTACATA-1	Myofibroblast_Mesothelium
GGAGGTACAACAGCTT-1	Myofibroblast_Mesothelium
GGAGGTACAGACACCC-1	Myofibroblast_Mesothelium
GGAGGTACAGATCACT-1	Fibroblasts
GGAGGTATCACTTTGT-1	Epithelial
GGAGGTATCGTTCCTG-1	Fibroblasts
GGAGGTATCTTAGCCC-1	Pericytes
GGATCTACACTCCGGA-1	Fibroblasts
GGATCTAGTAGACTGG-1	Pericytes
GGATCTAGTATGCGTT-1	Epithelial
GGATCTATCTCCTGCA-1	Fibroblasts
GGATGTTAGACGCTCC-1	Fibroblasts
GGATGTTTCCTCTAAT-1	Fibroblasts
GGATGTTTCTGATGGT-1	Fibroblasts
GGCACGTCACAGTGTT-1	Fibroblasts
GGCACGTCACTCAAGT-1	Epithelial
GGCACGTGTCCGTTTC-1	Fibroblasts
GGCACGTGTGGAGAAA-1	Epithelial
GGCACGTTCACCGCTT-1	Neural
GGCACGTTCATTTGGG-1	Epithelial
GGCAGTCAGACATAAC-1	Endothelial
GGCAGTCCAACTGCTA-1	Fibroblasts
GGCAGTCGTAACATGA-1	Fibroblasts
GGCAGTCGTAGTTCCA-1	Neural
GGCAGTCTCACCCTCA-1	Epithelial
GGCGTCAAGAACCGCA-1	Pericytes
GGCGTCAAGTGTCATC-1	Epithelial
GGCGTCACAGAAGCGT-1	Fibroblasts
GGCGTCATCCGCTTAC-1	Epithelial
GGCGTCATCTACCACC-1	Muscle
GGCTGTGAGTCATAGA-1	Fibroblasts
GGCTTGGAGATCCGAG-1	Epithelial
GGCTTGGAGCTCACTA-1	Neural
GGCTTGGGTATCATGC-1	Neural
GGCTTGGGTTGCCGCA-1	Epithelial
GGCTTGGTCGTTCAGA-1	Pericytes
GGCTTGGTCTGGTTGA-1	Fibroblasts
GGCTTTCCAAGTGACG-1	Fibroblasts
GGCTTTCCAGCACGAA-1	Epithelial
GGCTTTCCATTGACAC-1	Neural
GGCTTTCGTCCGTTTC-1	Fibroblasts
GGCTTTCGTGTTTGCA-1	Endothelial
GGCTTTCGTTGCAAGG-1	Fibroblasts
GGCTTTCTCATTGCCC-1	Fibroblasts
GGCTTTCTCTAAGAAG-1	Fibroblasts
GGGAAGTCAACGACTT-1	Fibroblasts
GGGAAGTCAGTCTTCC-1	Epithelial
GGGAAGTCATATGAAG-1	Myofibroblast_Mesothelium
GGGAAGTGTCTTTCTA-1	Epithelial
GGGACAATCTTTACAC-1	Fibroblasts
GGGACCTAGTCCTACA-1	Epithelial
GGGACCTTCGGAATTC-1	Epithelial
GGGACCTTCGTCAAAC-1	Neural
GGGACTCAGGACAACC-1	Epithelial
GGGACTCCAGAACCGA-1	Epithelial
GGGACTCGTCTGATAC-1	Myofibroblast_Mesothelium
GGGACTCGTTCTCTAT-1	Neural
GGGACTCTCTGGACTA-1	Fibroblasts
GGGAGATAGCCGTCGT-1	Endothelial
GGGAGATAGTCCGCGT-1	Epithelial
GGGAGATCATAACCCA-1	Muscle
GGGAGATGTCGCTTAA-1	Pericytes
GGGAGATGTTAAGGGC-1	Fibroblasts
GGGAGATTCGAGATAA-1	Neural
GGGAGATTCTACTGCC-1	Myofibroblast_Mesothelium
GGGAGTACACCAGTAT-1	Epithelial
GGGAGTATCCCTATTA-1	Neural
GGGATCCAGGGTGAGG-1	Endothelial
GGGATCCCACACCGCA-1	Epithelial
GGGATCCCAGGCGTTC-1	Epithelial
GGGATCCCATGACTAC-1	Endothelial
GGGATGACAGCGATTT-1	Epithelial
GGGATGACAGGCATTT-1	Myofibroblast_Mesothelium
GGGATGAGTCAACGCC-1	Myofibroblast_Mesothelium
GGGATGAGTCTTAGTG-1	Pericytes
GGGATGATCACCTTAT-1	Fibroblasts
GGGATGATCGGTCGGT-1	Epithelial
GGGATGATCGTCGGGT-1	Epithelial
GGGCCATCAACGACTT-1	Endothelial
GGGCCATCATCTTCGC-1	Epithelial
GGGCCATGTCCTCCTA-1	Epithelial
GGGCCATGTCGTCTCT-1	Epithelial
GGGCCATTCCATCTCG-1	Myofibroblast_Mesothelium
GGGCCATTCGCTTAAG-1	Epithelial
GGGCGTTCACCGTACG-1	Neural
GGGCTACAGACGACGT-1	Muscle
GGGCTACAGGACAGCT-1	Endothelial
GGGCTACGTACTAGCT-1	Fibroblasts
GGGCTACGTCACATTG-1	Epithelial
GGGCTACTCAAGGCTT-1	Epithelial
GGGCTCAAGATTGAGT-1	Neural
GGGCTCAAGTTGTCAC-1	Epithelial
GGGCTCACACTCTAGA-1	Epithelial
GGGCTCATCTGCTAGA-1	Endothelial
GGGTAGAAGCCTGAAG-1	Myofibroblast_Mesothelium
GGGTAGAAGCTGACAG-1	Fibroblasts
GGGTAGAAGGGTTTCT-1	Muscle
GGGTAGAAGGTTAAAC-1	Fibroblasts
GGGTAGACAACAGAGC-1	Fibroblasts
GGGTAGAGTACTCGTA-1	Fibroblasts
GGGTAGAGTCGGTACC-1	Fibroblasts
GGGTATTAGACAGTCG-1	Fibroblasts
GGGTATTCACCCTTAC-1	Pericytes
GGGTATTGTGGAAATT-1	Epithelial
GGGTATTTCGTAGTGT-1	Muscle
GGGTATTTCTAGTCAG-1	Epithelial
GGGTCACAGGTCCCTG-1	Pericytes
GGGTCACAGTAGTCTC-1	Endothelial
GGGTCACGTTCCACAA-1	Neural
GGGTCACTCACAACCA-1	Fibroblasts
GGGTCACTCAGAGCGA-1	Immune
GGGTCTGAGCTGGCTC-1	Fibroblasts
GGGTCTGAGTTGGCGA-1	Fibroblasts
GGGTCTGCACAACGAG-1	Fibroblasts
GGGTCTGTCCAGGACC-1	Epithelial
GGGTCTGTCCTTATGT-1	Fibroblasts
GGGTCTGTCGCAACAT-1	Fibroblasts
GGGTGAAAGGCGTTAG-1	Epithelial
GGGTGAAAGTAAGACT-1	Fibroblasts
GGGTGAACATCCCACT-1	Muscle
GGGTGAATCGGTGTTA-1	Epithelial
GGGTGAATCTGGACTA-1	Pericytes
GGGTGAATCTTGGCTC-1	Fibroblasts
GGGTGTCTCAGCGGAA-1	Myofibroblast_Mesothelium
GGGTGTCTCCTTGACC-1	Neural
GGGTGTCTCGCCTTTG-1	Fibroblasts
GGGTGTCTCGCTGTCT-1	Epithelial
GGGTGTCTCTAGCAAC-1	Fibroblasts
GGGTTATAGGAACTCG-1	Pericytes
GGGTTATAGGATGGCT-1	Neural
GGGTTATCACTTGTCC-1	Muscle
GGGTTATGTCCACTCT-1	Myofibroblast_Mesothelium
GGGTTATGTCTTCGAA-1	Fibroblasts
GGGTTATTCACGACTA-1	Epithelial
GGGTTATTCCACCCTA-1	Epithelial
GGGTTATTCTATGTGG-1	Epithelial
GGGTTTAAGATAACGT-1	Fibroblasts
GGGTTTAAGGATACCG-1	Fibroblasts
GGGTTTACATACATCG-1	Myofibroblast_Mesothelium
GGTAACTAGACTTAAG-1	Fibroblasts
GGTAACTAGCACTCGC-1	Epithelial
GGTAACTAGTAAAGCT-1	Myofibroblast_Mesothelium
GGTAACTCAACCACAT-1	Epithelial
GGTAACTCAGCGTTGC-1	Fibroblasts
GGTAACTGTTGTAAAG-1	Fibroblasts
GGTAACTTCCACCTCA-1	Epithelial
GGTAACTTCGGCATAT-1	Epithelial
GGTAATCCAAGCCATT-1	Myofibroblast_Mesothelium
GGTAATCCACAGCATT-1	Epithelial
GGTAATCGTCTGTAAC-1	Epithelial
GGTAATCGTTGCCTAA-1	Fibroblasts
GGTAATCTCAAACCTG-1	Endothelial
GGTAATCTCAACTACG-1	Fibroblasts
GGTAATCTCTTACGTT-1	Epithelial
GGTAGAGAGGGAGTTC-1	Epithelial
GGTAGAGAGTGCGTCC-1	Myofibroblast_Mesothelium
GGTAGAGGTTCCGCTT-1	Myofibroblast_Mesothelium
GGTAGAGTCACGACTA-1	Epithelial
GGTAGAGTCCGTATAG-1	Myofibroblast_Mesothelium
GGTAGAGTCGCAATTG-1	Epithelial
GGTCACGAGACCGTTT-1	Fibroblasts
GGTCACGAGCAGGCTA-1	Epithelial
GGTCACGAGGAAGTAG-1	Fibroblasts
GGTCACGCACTAGGTT-1	Muscle
GGTCTGGCAACTAGAA-1	Epithelial
GGTCTGGCAATTCGTG-1	Fibroblasts
GGTCTGGCATTAAGCC-1	Epithelial
GGTCTGGGTAACGGTG-1	Myofibroblast_Mesothelium
GGTCTGGGTGCAGGAT-1	Epithelial
GGTCTGGGTTGCATAC-1	Epithelial
GGTGAAGCAAGTGGCA-1	Fibroblasts
GGTGAAGTCGGTCACG-1	Fibroblasts
GGTGATTCAGGATCTT-1	Epithelial
GGTGATTCATAGAAAC-1	Epithelial
GGTGATTTCATGGGAG-1	Muscle
GGTGATTTCTGACCCT-1	Neural
GGTGGCTAGGTTTACC-1	Muscle
GGTGGCTCAATATCCG-1	Neural
GGTGGCTGTATGAGGC-1	Fibroblasts
GGTGGCTGTTCTATCT-1	Endothelial
GGTGGCTTCCTCACTG-1	Epithelial
GGTGGCTTCGGTAAGG-1	Neural
GGTGTCGCACCGTCGA-1	Neural
GGTGTCGCAGTCACGC-1	Myofibroblast_Mesothelium
GGTGTCGGTCGTCGGT-1	Neural
GGTGTCGGTTTCGTAG-1	Fibroblasts
GGTGTCGTCGTGCACG-1	Immune
GGTGTCGTCTTAGCTT-1	Myofibroblast_Mesothelium
GGTGTTAAGATGTTGA-1	Endothelial
GGTGTTAAGCATATGA-1	Myofibroblast_Mesothelium
GGTGTTACATGGGTTT-1	Epithelial
GGTGTTACATGTTACG-1	Myofibroblast_Mesothelium
GGTGTTAGTATCCCAA-1	Epithelial
GGTTAACAGTACCGGA-1	Fibroblasts
GGTTAACCAGTAGTGG-1	Fibroblasts
GGTTAACGTGTGTGGA-1	Pericytes
GGTTAACGTTAATCGC-1	Fibroblasts
GGTTAACTCATAAGGA-1	Muscle
GGTTAACTCTTCTGTA-1	Fibroblasts
GGTTCTCCAAGGGTCA-1	Fibroblasts
GGTTCTCCAGCTTTCC-1	Epithelial
GGTTCTCGTCATTGCA-1	Epithelial
GGTTCTCGTCGTACTA-1	Endothelial
GGTTCTCGTTTATGCG-1	Immune
GGTTCTCTCCGTGTCT-1	Fibroblasts
GGTTGTAAGTGAGGTC-1	Endothelial
GGTTGTACACGCAGTC-1	Fibroblasts
GGTTGTAGTCGCTTAA-1	Epithelial
GGTTGTAGTCGTGGAA-1	Pericytes
GGTTGTAGTGTTAACC-1	Fibroblasts
GTAACACAGCACCAGA-1	Epithelial
GTAACACAGGGATCTG-1	Epithelial
GTAACACAGTCATTGC-1	Epithelial
GTAACACCAGAACCGA-1	Myofibroblast_Mesothelium
GTAACACTCTCCGTGT-1	Neural
GTAACCAAGCAGCCTC-1	Fibroblasts
GTAACCAAGGCGTTGA-1	Endothelial
GTAAGTCCAGTGAGCA-1	Muscle
GTAAGTCTCCATACTT-1	Immune
GTAAGTCTCTTCCCAG-1	Epithelial
GTAATCGTCATGCCAA-1	Myofibroblast_Mesothelium
GTAATCGTCGCAGAGA-1	Myofibroblast_Mesothelium
GTAATGCAGGACCCAA-1	Neural
GTAATGCAGGTCACCC-1	Muscle
GTAATGCCAAGTCGTT-1	Myofibroblast_Mesothelium
GTAATGCCAGCCCACA-1	Epithelial
GTAATGCCAGTCCGTG-1	Neural
GTAATGCTCTCATTAC-1	Fibroblasts
GTAATGCTCTGCACCT-1	Epithelial
GTACAACAGCTTTGTG-1	Myofibroblast_Mesothelium
GTACAACAGGGCATGT-1	Neural
GTACAACCACGATTCA-1	Pericytes
GTACAACGTCAGGCAA-1	Epithelial
GTACAGTAGAGAGCCT-1	Epithelial
GTACAGTAGGGCCCTT-1	Muscle
GTACAGTAGTATGTAG-1	Fibroblasts
GTACAGTCAAAGCAAT-1	Epithelial
GTACAGTCACGATAGG-1	Fibroblasts
GTACAGTCACGTTGGC-1	Fibroblasts
GTACAGTGTATCATGC-1	Immune
GTAGAAAAGCACCTGC-1	Myofibroblast_Mesothelium
GTAGAAAGTCAGACTT-1	Pericytes
GTAGAAATCGATGCAT-1	Epithelial
GTAGAGGTCCACCTCA-1	Endothelial
GTAGATCAGCCATTCA-1	Epithelial
GTAGATCCAGTGTACT-1	Epithelial
GTAGATCGTAGCGTTT-1	Epithelial
GTAGATCGTAGCTTGT-1	Endothelial
GTAGATCTCGACGAGA-1	Fibroblasts
GTAGCTAAGAGGCCAT-1	Endothelial
GTAGCTAAGGCCGCTT-1	Fibroblasts
GTAGCTAAGTAATACG-1	Fibroblasts
GTAGCTAGTGGCTACC-1	Epithelial
GTAGCTAGTTCCTAAG-1	Epithelial
GTAGCTATCCCAATAG-1	Epithelial
GTAGGAGCACAACGCC-1	Epithelial
GTAGGAGGTCCGGTGT-1	Immune
GTAGGAGGTTCTCCCA-1	Fibroblasts
GTAGGAGGTTTCGGCG-1	Epithelial
GTAGGAGTCAAGCTTG-1	Epithelial
GTAGGAGTCATCCTGC-1	Endothelial
GTAGGAGTCCAAACCA-1	Myofibroblast_Mesothelium
GTAGGTTAGTAGCAAT-1	Fibroblasts
GTAGGTTAGTGAGGTC-1	Myofibroblast_Mesothelium
GTAGGTTGTAGTAAGT-1	Epithelial
GTAGGTTGTTCTATCT-1	Fibroblasts
GTAGGTTTCACGGGCT-1	Fibroblasts
GTAGTACAGACGGTCA-1	Fibroblasts
GTAGTACGTGTAGTGG-1	Epithelial
GTAGTACGTTCCGGTG-1	Neural
GTAGTACTCTACGCGG-1	Fibroblasts
GTAGTACTCTTGCAGA-1	Fibroblasts
GTATTGGCAGTTGGTT-1	Myofibroblast_Mesothelium
GTATTGGGTTAGCTAC-1	Fibroblasts
GTATTGGGTTCCGGTG-1	Muscle
GTATTGGTCACTCCGT-1	Epithelial
GTATTGGTCTAAGCCA-1	Endothelial
GTATTTCAGGCGTCCT-1	Neural
GTATTTCCAATTGCGT-1	Fibroblasts
GTATTTCGTAGATTAG-1	Fibroblasts
GTATTTCTCGTACCTC-1	Endothelial
GTATTTCTCTCATGGA-1	Myofibroblast_Mesothelium
GTCAAACAGCAACAGC-1	Fibroblasts
GTCAAACCATAGATCC-1	Immune
GTCAAACGTAATTAGG-1	Epithelial
GTCAAACTCCCGAAAT-1	Epithelial
GTCAAACTCGAGAGAC-1	Epithelial
GTCAAACTCTCAATCT-1	Epithelial
GTCAAGTAGAATGTTG-1	Pericytes
GTCAAGTAGTCCTGTA-1	Neural
GTCAAGTGTCAAGCCC-1	Fibroblasts
GTCACGGAGTACAGCG-1	Fibroblasts
GTCACGGAGTGGTGAC-1	Fibroblasts
GTCACGGCAACAAGAT-1	Neural
GTCACGGCAATCGTCA-1	Myofibroblast_Mesothelium
GTCACGGCAATTTCTC-1	Fibroblasts
GTCACGGCACTGAGGA-1	Fibroblasts
GTCACGGCAGCGACAA-1	Myofibroblast_Mesothelium
GTCACTCAGGACAAGA-1	Myofibroblast_Mesothelium
GTCACTCAGGGTAATT-1	Epithelial
GTCACTCCACAAGTTC-1	Pericytes
GTCACTCCATCGGTTA-1	Neural
GTCACTCGTGATTCAC-1	Epithelial
GTCACTCGTTTGTGGT-1	Fibroblasts
GTCAGCGAGACTAGAT-1	Fibroblasts
GTCAGCGCACGACCTG-1	Fibroblasts
GTCAGCGCATATCTCT-1	Fibroblasts
GTCAGCGGTTCCACGG-1	Pericytes
GTCAGCGGTTGAGGAC-1	Neural
GTCAGCGGTTTGCCGG-1	Myofibroblast_Mesothelium
GTCATCCAGCGACCCT-1	Endothelial
GTCATCCAGGATACGC-1	Neural
GTCATCCAGTCACTCA-1	Epithelial
GTCATCCTCCACTTCG-1	Fibroblasts
GTCATGACAATCCAGT-1	Endothelial
GTCATGAGTAACAGTA-1	Fibroblasts
GTCATGATCTTCGACC-1	Epithelial
GTCATGATCTTTCGAT-1	Fibroblasts
GTCATTTAGTAAACAC-1	Fibroblasts
GTCATTTAGTGGTGGT-1	Epithelial
GTCATTTAGTTTCGAC-1	Epithelial
GTCATTTGTGACACGA-1	Epithelial
GTCATTTTCCAGTACA-1	Epithelial
GTCCACTCATAGGAGC-1	Neural
GTCCACTGTCGACTGC-1	Myofibroblast_Mesothelium
GTCCACTTCTGCTTAT-1	Myofibroblast_Mesothelium
GTCCCATCACTTACAG-1	Epithelial
GTCCCATCAGGACTTT-1	Fibroblasts
GTCCCATGTCAAATCC-1	Fibroblasts
GTCCTCACAGAGTCTT-1	Neural
GTCCTCAGTAGGTCAG-1	Myofibroblast_Mesothelium
GTCCTCATCGGAACTT-1	Epithelial
GTCGAATGTAGCTTAC-1	Fibroblasts
GTCGAATGTCTAGATC-1	Myofibroblast_Mesothelium
GTCGCGACAACCCGCA-1	Pericytes
GTCGCGACAGACGATG-1	Epithelial
GTCGCGACATTGGATC-1	Fibroblasts
GTCGCGAGTACTGGGA-1	Epithelial
GTCGCGAGTTCCTAAG-1	Endothelial
GTCGTAAAGTATAGGT-1	Epithelial
GTCGTTCCACTGATTG-1	Fibroblasts
GTCGTTCCACTGGATT-1	Epithelial
GTCGTTCCATTGACAC-1	Muscle
GTCGTTCTCCCTGGTT-1	Fibroblasts
GTCGTTCTCTGGTGGC-1	Pericytes
GTCTACCAGACTAAGT-1	Pericytes
GTCTACCAGCCACAAG-1	Neural
GTCTACCGTAGGTCAG-1	Myofibroblast_Mesothelium
GTCTACCGTATACCTG-1	Fibroblasts
GTCTACCGTGCGGATA-1	Myofibroblast_Mesothelium
GTCTACCTCCATTGTT-1	Endothelial
GTCTACCTCGCTGACG-1	Endothelial
GTCTACCTCTACCAGA-1	Myofibroblast_Mesothelium
GTCTAGAAGGCTTCCG-1	Epithelial
GTCTAGAAGGGCGAAG-1	Epithelial
GTCTAGAGTATCGGTT-1	Muscle
GTCTAGATCCATCAGA-1	Myofibroblast_Mesothelium
GTCTCACAGTCAATCC-1	Fibroblasts
GTCTCACCACTGTCCT-1	Epithelial
GTCTCACGTGCCGTTG-1	Neural
GTCTCACGTGCCTTTC-1	Endothelial
GTCTCACTCTATACTC-1	Pericytes
GTCTGTCAGCGACAGT-1	Endothelial
GTCTGTCCACGTGAGA-1	Fibroblasts
GTCTGTCGTAGCGTAG-1	Immune
GTCTGTCGTGACACGA-1	Fibroblasts
GTCTGTCTCACTTATC-1	Endothelial
GTCTGTCTCGAGTGAG-1	Epithelial
GTCTTTAAGGTCGTGA-1	Epithelial
GTCTTTAGTATCCCAA-1	Endothelial
GTCTTTAGTTACGGAG-1	Fibroblasts
GTCTTTATCCATTTAC-1	Fibroblasts
GTCTTTATCTCTTGCG-1	Epithelial
GTGACGCAGTCAGCGA-1	Fibroblasts
GTGACGCCATCGGAGA-1	Myofibroblast_Mesothelium
GTGAGCCCAGACAAAT-1	Epithelial
GTGAGCCGTCACCGCA-1	Epithelial
GTGAGCCGTTCTCAGA-1	Neural
GTGAGGACAAGCGCTC-1	Epithelial
GTGAGGACAATCCTAG-1	Myofibroblast_Mesothelium
GTGAGGACACTGTGAT-1	Epithelial
GTGAGGATCATGACAC-1	Fibroblasts
GTGAGTTAGCTACTAC-1	Epithelial
GTGAGTTCAACTGCTA-1	Neural
GTGAGTTCAGCTATAC-1	Epithelial
GTGAGTTCATGTCTAG-1	Myofibroblast_Mesothelium
GTGAGTTGTGGTAATA-1	Neural
GTGAGTTGTTGACGGA-1	Myofibroblast_Mesothelium
GTGAGTTTCTACTTCA-1	Pericytes
GTGATGTAGAAGTCAT-1	Epithelial
GTGATGTAGCACTCTA-1	Neural
GTGATGTAGCTTACGT-1	Fibroblasts
GTGATGTAGGTTAGTA-1	Endothelial
GTGATGTAGTAACCTC-1	Epithelial
GTGATGTAGTGGATTA-1	Epithelial
GTGATGTAGTGTAGTA-1	Pericytes
GTGATGTGTAAGTAGT-1	Muscle
GTGATGTGTCCGAAAG-1	Fibroblasts
GTGATGTTCGCATGAT-1	Fibroblasts
GTGCACGAGGTGCGAT-1	Epithelial
GTGCACGGTGTCATCA-1	Myofibroblast_Mesothelium
GTGCACGTCAAAGCCT-1	Neural
GTGCACGTCAAGAAAC-1	Pericytes
GTGCACGTCAAGTTGC-1	Endothelial
GTGCAGCCAATTGCTG-1	Fibroblasts
GTGCAGCCACAACCGC-1	Fibroblasts
GTGCAGCCAGCTACTA-1	Myofibroblast_Mesothelium
GTGCAGCGTCTAACTG-1	Epithelial
GTGCGTGAGTCCTGTA-1	Fibroblasts
GTGCGTGCATTGGATC-1	Endothelial
GTGCTGGAGACGCTCC-1	Neural
GTGCTGGAGCGAACTG-1	Fibroblasts
GTGCTGGAGGTAAACT-1	Fibroblasts
GTGCTGGCAATTGCGT-1	Myofibroblast_Mesothelium
GTGCTGGCAGAAATCA-1	Neural
GTGCTGGGTAGGACCA-1	Pericytes
GTGCTGGGTGAGTCAG-1	Fibroblasts
GTGCTGGGTTCTTCAT-1	Endothelial
GTGCTGGTCAACTCTT-1	Fibroblasts
GTGCTGGTCATTGTTC-1	Myofibroblast_Mesothelium
GTGCTGGTCTTTCAGT-1	Myofibroblast_Mesothelium
GTGCTTCCAAGTGCAG-1	Pericytes
GTGCTTCTCAACTGAC-1	Fibroblasts
GTGCTTCTCCTACCGT-1	Fibroblasts
GTGGAAGGTAGCTGTT-1	Fibroblasts
GTGGAAGGTCGGTAAG-1	Muscle
GTGGAAGGTCGTACAT-1	Fibroblasts
GTGGAAGGTTTACACG-1	Fibroblasts
GTGGAGAAGTCATGAA-1	Epithelial
GTGGAGACAAGGTTGG-1	Neural
GTGGAGACACCTAAAC-1	Pericytes
GTGGAGACATTGAAGA-1	Epithelial
GTGGAGATCAAAGCCT-1	Epithelial
GTGGAGATCGGTGTAT-1	Myofibroblast_Mesothelium
GTGGCGTCACCGCTGA-1	Myofibroblast_Mesothelium
GTGGCGTCAGGTGAGT-1	Endothelial
GTGGGAAAGACGACTG-1	Fibroblasts
GTGGGAAAGATACTGA-1	Fibroblasts
GTGGGAAAGCATCAGG-1	Myofibroblast_Mesothelium
GTGGGAAAGCTGGCCT-1	Epithelial
GTGGGAAAGGACTGGT-1	Endothelial
GTGGGAACAGACATCT-1	Epithelial
GTGGGAAGTCTCAGAT-1	Epithelial
GTGGTTAAGCCGGAAT-1	Fibroblasts
GTGGTTACATGAATAG-1	Myofibroblast_Mesothelium
GTGGTTAGTTGTCCCT-1	Fibroblasts
GTGGTTATCCGGACGT-1	Fibroblasts
GTGTAACGTGTGTCGC-1	Epithelial
GTGTAACGTTTATGCG-1	Neural
GTGTAACTCATCGCTC-1	Epithelial
GTGTAACTCATGCATG-1	Myofibroblast_Mesothelium
GTGTAACTCTAACGGT-1	Immune
GTGTCCTAGACCATAA-1	Epithelial
GTGTCCTCATTGCAAC-1	Muscle
GTGTCCTGTTCGTACA-1	Fibroblasts
GTGTGATAGCATGGGT-1	Neural
GTGTGATAGGCAATGC-1	Fibroblasts
GTGTGATAGGCTAAAT-1	Fibroblasts
GTGTGATCAAAGCGTG-1	Endothelial
GTGTGATCACACCTTC-1	Epithelial
GTGTGATCAGCTAACT-1	Fibroblasts
GTGTGATGTACGAGCA-1	Myofibroblast_Mesothelium
GTGTGATTCCATTCAT-1	Epithelial
GTGTGATTCGTTACCC-1	Immune
GTGTGGCAGGAGAATG-1	Myofibroblast_Mesothelium
GTGTGGCAGGTGGTTG-1	Fibroblasts
GTGTTAGAGTAAGACT-1	Epithelial
GTGTTAGAGTGCTACT-1	Fibroblasts
GTGTTAGGTATGGAAT-1	Immune
GTGTTAGGTTCATCGA-1	Fibroblasts
GTGTTAGTCGAGGCAA-1	Myofibroblast_Mesothelium
GTGTTAGTCGTGTCAA-1	Neural
GTGTTCCAGAGGTGCT-1	Fibroblasts
GTGTTCCAGCATTTCG-1	Muscle
GTGTTCCAGCTAATCC-1	Fibroblasts
GTGTTCCCACTAAACC-1	Epithelial
GTGTTCCCAGTAACGG-1	Neural
GTGTTCCGTCCTTAAG-1	Endothelial
GTGTTCCGTTGGGCCT-1	Neural
GTGTTCCTCACCTCTG-1	Endothelial
GTGTTCCTCAGGTAAA-1	Epithelial
GTTACAGAGCTCTGTA-1	Fibroblasts
GTTACAGAGGCCACCT-1	Epithelial
GTTACAGAGTGGTGGT-1	Epithelial
GTTACAGGTGTCATTG-1	Epithelial
GTTACAGTCCGCTAGG-1	Endothelial
GTTACAGTCGCTGCGA-1	Epithelial
GTTACCCAGAAGCGAA-1	Fibroblasts
GTTACCCCACTTGAAC-1	Epithelial
GTTACCCGTCGTCGGT-1	Myofibroblast_Mesothelium
GTTACCCTCAGGAGAC-1	Epithelial
GTTACGAAGCTATCTG-1	Myofibroblast_Mesothelium
GTTACGACAAGCGGAT-1	Myofibroblast_Mesothelium
GTTACGACACATCCCT-1	Epithelial
GTTACGAGTACAGTCT-1	Endothelial
GTTACGAGTAGGCAAC-1	Epithelial
GTTACGAGTGCCTTCT-1	Epithelial
GTTACGATCGAGAAAT-1	Fibroblasts
GTTACGATCTATTTCG-1	Myofibroblast_Mesothelium
GTTAGACAGCGGACAT-1	Pericytes
GTTAGACCACCGTGGT-1	Neural
GTTAGACGTGATAGAT-1	Myofibroblast_Mesothelium
GTTAGACTCCTTGACC-1	Epithelial
GTTAGTGAGAATTGCA-1	Pericytes
GTTAGTGAGGACACTG-1	Endothelial
GTTAGTGAGTTCATGC-1	Fibroblasts
GTTAGTGGTACACTCA-1	Neural
GTTATGGTCGACATCA-1	Endothelial
GTTATGGTCGGTATGT-1	Fibroblasts
GTTCATTGTACCGCGT-1	Epithelial
GTTCATTTCCTTCAGC-1	Epithelial
GTTCCGTCACGGCACT-1	Fibroblasts
GTTCCGTGTACGAGCA-1	Epithelial
GTTCCGTGTCTGTAGT-1	Epithelial
GTTCCGTTCACGACTA-1	Fibroblasts
GTTCCGTTCCAGTACA-1	Epithelial
GTTCCGTTCGAGTCCG-1	Epithelial
GTTCGCTAGTCTCTGA-1	Epithelial
GTTCGCTAGTGGATAT-1	Fibroblasts
GTTCGCTCAGCACCCA-1	Epithelial
GTTCGCTGTCTTCAAG-1	Epithelial
GTTCGCTGTTCGTAAC-1	Endothelial
GTTCGCTTCGGTAAGG-1	Muscle
GTTCTATAGACCAAGC-1	Epithelial
GTTCTATCAAGTATCC-1	Epithelial
GTTCTATGTGATTGGG-1	Fibroblasts
GTTCTATTCAACTGGT-1	Fibroblasts
GTTGAACAGAGGTCAC-1	Fibroblasts
GTTGAACAGCTTTGTG-1	Epithelial
GTTGAACCAATTGCTG-1	Fibroblasts
GTTGAACCACTTTATC-1	Myofibroblast_Mesothelium
GTTGAACCATGGCACC-1	Epithelial
GTTGAACGTTCGCGTG-1	Neural
GTTGAACTCAATCCGA-1	Fibroblasts
GTTGCGGCAACGCCCA-1	Fibroblasts
GTTGCGGCACACGTGC-1	Myofibroblast_Mesothelium
GTTGCGGCACTCTCGT-1	Pericytes
GTTGCGGGTGGACCAA-1	Neural
GTTGCGGGTTCCGGTG-1	Myofibroblast_Mesothelium
GTTGCGGTCCAAAGGG-1	Myofibroblast_Mesothelium
GTTGCGGTCCGCTAGG-1	Neural
GTTGCGGTCCTCGATC-1	Pericytes
GTTGCGGTCCTTCAGC-1	Myofibroblast_Mesothelium
GTTGCGGTCTGTTCAT-1	Fibroblasts
GTTGCGGTCTTGCGCT-1	Myofibroblast_Mesothelium
GTTGCTCAGATACAGT-1	Endothelial
GTTGCTCAGTAGCTCT-1	Fibroblasts
GTTGCTCCAGACGCTC-1	Neural
GTTGCTCGTACTGCGC-1	Pericytes
GTTGCTCGTCGTGGTC-1	Epithelial
GTTGCTCGTTATGTGC-1	Neural
GTTGCTCGTTCAGCTA-1	Epithelial
GTTGCTCTCCATACTT-1	Fibroblasts
GTTGTAGAGAATCGAT-1	Fibroblasts
GTTGTAGAGCAACCAG-1	Endothelial
GTTGTAGAGCATCAGG-1	Muscle
GTTGTAGCAATCTAGC-1	Fibroblasts
GTTGTAGGTCGCGTTG-1	Myofibroblast_Mesothelium
GTTGTAGTCCGATAGT-1	Endothelial
GTTGTCCTCAGAGTTC-1	Neural
GTTGTCCTCGTTCGCT-1	Fibroblasts
GTTGTGAAGGTCCAGA-1	Pericytes
GTTGTGATCCACTTCG-1	Neural
GTTGTGATCCAGCTCT-1	Fibroblasts
GTTTACTAGAGAGGGC-1	Neural
GTTTACTAGCATCAAA-1	Epithelial
GTTTACTAGGCGTTAG-1	Epithelial
GTTTACTCAAAGCTAA-1	Epithelial
GTTTACTCATAGGAGC-1	Epithelial
GTTTACTGTCATCACA-1	Fibroblasts
GTTTACTGTGCATTTG-1	Myofibroblast_Mesothelium
GTTTACTGTGTCCGTG-1	Endothelial
GTTTACTTCCAACCGG-1	Immune
TAACACGAGGCCTGAA-1	Fibroblasts
TAACACGCAAGTACCT-1	Fibroblasts
TAACACGCAGCACCCA-1	Fibroblasts
TAACACGGTCTGATAC-1	Pericytes
TAACACGTCAAAGGAT-1	Myofibroblast_Mesothelium
TAACACGTCGTCGATA-1	Pericytes
TAACACGTCTACTATC-1	Epithelial
TAACCAGAGATTGCGG-1	Epithelial
TAACCAGAGTACCCTA-1	Fibroblasts
TAACCAGCATGCTGCG-1	Myofibroblast_Mesothelium
TAACCAGCATTGCTTT-1	Pericytes
TAACCAGGTCGAACGA-1	Epithelial
TAACCAGTCGAGGCAA-1	Fibroblasts
TAACCAGTCGTAACTG-1	Neural
TAACGACAGAGTCTTC-1	Epithelial
TAACGACCACTTTATC-1	Fibroblasts
TAACGACGTCGAACAG-1	Endothelial
TAACGACTCCCTAGGG-1	Fibroblasts
TAACTTCCACCAAATC-1	Fibroblasts
TAACTTCGTAGTTCCA-1	Myofibroblast_Mesothelium
TAACTTCTCACTGCTC-1	Endothelial
TAAGCACGTCAGATTC-1	Endothelial
TAAGCACTCCGCTGTT-1	Epithelial
TAAGCACTCCGTGGCA-1	Neural
TAAGCACTCGCAATGT-1	Fibroblasts
TAAGCCAAGAGGGCGA-1	Myofibroblast_Mesothelium
TAAGCCAAGTGGTTCT-1	Endothelial
TAAGCCACACACAGCC-1	Fibroblasts
TAAGCCACATAGATGA-1	Fibroblasts
TAAGCGTAGAGTTGTA-1	Endothelial
TAAGCGTAGCGTCTCG-1	Epithelial
TAAGCGTCAAGACGGT-1	Epithelial
TAAGCGTCAATTAGGA-1	Fibroblasts
TAAGCGTCATTGAGGG-1	Fibroblasts
TAAGCGTGTACTCGAT-1	Fibroblasts
TAAGCGTGTCACGTGC-1	Myofibroblast_Mesothelium
TAAGCGTGTGGGCTTC-1	Fibroblasts
TAAGCGTTCACGTAGT-1	Endothelial
TAAGTCGCAGTGGTGA-1	Fibroblasts
TAAGTCGGTTCCACAA-1	Endothelial
TAAGTCGTCACCGCTT-1	Fibroblasts
TAAGTCGTCGGTCTGG-1	Fibroblasts
TAATCTCAGCGTATAA-1	Myofibroblast_Mesothelium
TAATCTCAGTCGAAAT-1	Endothelial
TAATCTCAGTCGCCAC-1	Myofibroblast_Mesothelium
TAATCTCGTTCGAAGG-1	Endothelial
TAATCTCGTTGTGTTG-1	Neural
TAATCTCTCACTTGGA-1	Endothelial
TAATCTCTCGAACCTA-1	Myofibroblast_Mesothelium
TAATCTCTCTTCACAT-1	Endothelial
TAATTCCAGCTTGTGT-1	Fibroblasts
TAATTCCCAGGTGGAT-1	Epithelial
TAATTCCGTGAGACCA-1	Myofibroblast_Mesothelium
TAATTCCGTTCGGCCA-1	Fibroblasts
TAATTCCTCATTGTGG-1	Epithelial
TAATTCCTCCAGCAAT-1	Fibroblasts
TACAACGAGACCCTTA-1	Fibroblasts
TACAACGAGTATTCCG-1	Fibroblasts
TACAACGCAATCAGCT-1	Fibroblasts
TACAACGCAGTTCTAG-1	Fibroblasts
TACAACGGTCGGCTAC-1	Fibroblasts
TACAACGGTGACAACG-1	Neural
TACAACGGTGCGACAA-1	Fibroblasts
TACAACGGTTTACCTT-1	Epithelial
TACACCCAGATGCTGG-1	Endothelial
TACACCCAGGAGATAG-1	Myofibroblast_Mesothelium
TACACCCAGGTAGTAT-1	Epithelial
TACACCCAGTTCTACG-1	Epithelial
TACACCCCAGACAAAT-1	Epithelial
TACAGGTCAAATGAGT-1	Fibroblasts
TACAGGTCATAGATCC-1	Epithelial
TACATTCAGAGCCCAA-1	Fibroblasts
TACATTCAGGCACGAT-1	Endothelial
TACATTCCAACTGCTA-1	Pericytes
TACATTCGTGTCATCA-1	Neural
TACATTCTCCACACCT-1	Epithelial
TACATTCTCGCTACGG-1	Epithelial
TACATTCTCTTCCTAA-1	Fibroblasts
TACCCACAGAGATGCC-1	Epithelial
TACCCACAGCGTATGG-1	Fibroblasts
TACCCACAGTGTTCCA-1	Myofibroblast_Mesothelium
TACCCACCAAGAGGCT-1	Neural
TACCCACCAGCTGTTA-1	Fibroblasts
TACCCGTAGACTCAAA-1	Neural
TACCCGTAGGTACTGG-1	Myofibroblast_Mesothelium
TACCCGTCACTCCCTA-1	Fibroblasts
TACCGAAAGACCAGAC-1	Pericytes
TACCGAAAGTTCGGTT-1	Fibroblasts
TACCGAACAGGTTTAC-1	Endothelial
TACCGAACATGTGCCG-1	Fibroblasts
TACCGGGAGATGGGCT-1	Fibroblasts
TACCGGGAGCTTTCTT-1	Fibroblasts
TACCGGGAGTCGTTAC-1	Neural
TACCGGGCAGGCACAA-1	Fibroblasts
TACCGGGGTCGAGTTT-1	Myofibroblast_Mesothelium
TACCGGGTCGCAGTGC-1	Pericytes
TACCTCGAGATGGCAC-1	Muscle
TACCTCGAGTTGTAGA-1	Pericytes
TACCTCGTCACAACCA-1	Fibroblasts
TACCTCGTCTGAATGC-1	Fibroblasts
TACCTGCAGGCTGTAG-1	Epithelial
TACCTGCCACTGGATT-1	Neural
TACCTGCCAGATTAAG-1	Fibroblasts
TACCTGCCAGTCGGTC-1	Fibroblasts
TACCTGCGTCTCTCTG-1	Muscle
TACGCTCAGACCAACG-1	Myofibroblast_Mesothelium
TACGCTCAGGCAGGGA-1	Endothelial
TACGCTCGTATCTCGA-1	Epithelial
TACGCTCGTCCCAAAT-1	Epithelial
TACGCTCTCAGACTGT-1	Epithelial
TACGCTCTCCAAATGC-1	Neural
TACGGGCAGACAACAT-1	Neural
TACGGGCAGAGGGTAA-1	Myofibroblast_Mesothelium
TACGGGCAGGGTTGCA-1	Myofibroblast_Mesothelium
TACGGGCCAGAGAAAG-1	Immune
TACGGGCGTGCGTGCT-1	Fibroblasts
TACGGGCTCAGGAAGC-1	Myofibroblast_Mesothelium
TACGGGCTCGCCAGAC-1	Fibroblasts
TACGGTAGTCCTCCAT-1	Fibroblasts
TACGGTAGTCTAGGTT-1	Epithelial
TACGGTATCCACCTGT-1	Fibroblasts
TACGTCCAGCATAGGC-1	Epithelial
TACGTCCGTAGCTGCC-1	Fibroblasts
TACGTCCGTATCGCTA-1	Fibroblasts
TACGTCCTCTGTCGCT-1	Epithelial
TACTGCCAGCAGCAGT-1	Epithelial
TACTGCCAGGACATCG-1	Epithelial
TACTGCCCACACCAGC-1	Neural
TACTGCCTCAGATGCT-1	Myofibroblast_Mesothelium
TACTGCCTCCCTCTTT-1	Fibroblasts
TACTGCCTCGACATTG-1	Epithelial
TACTGCCTCGCTCCTA-1	Myofibroblast_Mesothelium
TACTGCCTCGTTAGAC-1	Fibroblasts
TACTGCCTCTGAGGTT-1	Neural
TACTTACAGTGACACG-1	Fibroblasts
TACTTACGTACACGCC-1	Fibroblasts
TACTTACTCACCATAG-1	Muscle
TACTTACTCATCTGTT-1	Muscle
TACTTACTCGTTCATT-1	Epithelial
TACTTACTCTTTACAC-1	Fibroblasts
TACTTCAAGCCGTCGT-1	Endothelial
TACTTCAAGGTCTACT-1	Fibroblasts
TACTTCAGTGGAAATT-1	Endothelial
TACTTGTTCAAGCCGC-1	Fibroblasts
TACTTGTTCTTCGGAA-1	Myofibroblast_Mesothelium
TAGACCAAGGTAGCAC-1	Epithelial
TAGACCAGTACAACGG-1	Neural
TAGACCAGTCTTGGTA-1	Myofibroblast_Mesothelium
TAGACCAGTTCCACGG-1	Epithelial
TAGACTGTCTGAATCG-1	Fibroblasts
TAGAGTCAGACTTCGT-1	Epithelial
TAGAGTCAGTTGGGAC-1	Pericytes
TAGAGTCTCACTACGA-1	Epithelial
TAGAGTCTCGAGAAGC-1	Myofibroblast_Mesothelium
TAGAGTCTCTTAGCTT-1	Epithelial
TAGATCGCAGTTGTTG-1	Epithelial
TAGATCGGTAGCTGCC-1	Myofibroblast_Mesothelium
TAGATCGGTGTTACTG-1	Immune
TAGATCGGTTTCGACA-1	Epithelial
TAGCACAAGCACTCGC-1	Pericytes
TAGCACAGTACTCGCG-1	Myofibroblast_Mesothelium
TAGCACAGTCAGACGA-1	Neural
TAGGAGGAGACAGCGT-1	Fibroblasts
TAGGAGGGTGGATACG-1	Fibroblasts
TAGGAGGGTTGTGTAC-1	Epithelial
TAGGGTTAGAGCCCAA-1	Epithelial
TAGGGTTAGATTGGGC-1	Fibroblasts
TAGGGTTAGTAACCGG-1	Pericytes
TAGGGTTCACGGCGTT-1	Epithelial
TAGGTACAGCAAGCCA-1	Pericytes
TAGGTACAGCTACTAC-1	Endothelial
TAGGTACAGCTTTCTT-1	Endothelial
TAGGTACCAATAGGAT-1	Epithelial
TAGGTACCAGCGTTGC-1	Endothelial
TAGGTTGAGGACTTCT-1	Pericytes
TAGGTTGAGTAGGATT-1	Myofibroblast_Mesothelium
TAGGTTGCAAAGCGTG-1	Fibroblasts
TAGGTTGTCAAACCCA-1	Myofibroblast_Mesothelium
TAGGTTGTCACCCTGT-1	Endothelial
TAGGTTGTCTCTATAC-1	Myofibroblast_Mesothelium
TAGGTTGTCTGAGCAT-1	Fibroblasts
TAGTGCACAGGTGACA-1	Endothelial
TATACCTAGAGCTGCA-1	Epithelial
TATACCTGTAGAGTTA-1	Myofibroblast_Mesothelium
TATACCTGTCGATGCC-1	Epithelial
TATACCTGTCTTACAG-1	Fibroblasts
TATATCCAGGCTCCCA-1	Epithelial
TATATCCCAAGCAGGT-1	Myofibroblast_Mesothelium
TATATCCTCGCTACGG-1	Myofibroblast_Mesothelium
TATATCCTCGGAAACG-1	Fibroblasts
TATATCCTCTAGACAC-1	Epithelial
TATCAGGAGACCTGGA-1	Myofibroblast_Mesothelium
TATCAGGCAGCAGTTT-1	Fibroblasts
TATCAGGGTGACTATC-1	Fibroblasts
TATCAGGGTGGATACG-1	Fibroblasts
TATCAGGTCAGTGATC-1	Fibroblasts
TATCAGGTCGTAGTCA-1	Fibroblasts
TATCCTACACGGTGAA-1	Fibroblasts
TATCCTACAGTCTGGC-1	Pericytes
TATCCTAGTGTCTCCT-1	Fibroblasts
TATCGCCAGACATCCT-1	Fibroblasts
TATCGCCCACCCTAAA-1	Fibroblasts
TATCGCCCATGTGGCC-1	Epithelial
TATCGCCTCCGATGTA-1	Fibroblasts
TATCGCCTCGCGTCGA-1	Epithelial
TATCTGTAGTTACGAA-1	Epithelial
TATCTGTGTATCGAAA-1	Fibroblasts
TATCTGTTCAACCTTT-1	Fibroblasts
TATCTGTTCACGGAGA-1	Epithelial
TATCTGTTCAGTCTTT-1	Endothelial
TATCTGTTCTTACCAT-1	Pericytes
TATCTTGAGTTGCTCA-1	Fibroblasts
TATCTTGCATCATCCC-1	Pericytes
TATCTTGGTCTACGAT-1	Fibroblasts
TATCTTGGTGACACGA-1	Immune
TATGTTCAGTCCTACA-1	Myofibroblast_Mesothelium
TATGTTCCAACGACTT-1	Epithelial
TATGTTCCACTTGGGC-1	Neural
TATGTTCCATGTTTGG-1	Fibroblasts
TATGTTCGTGAGTCAG-1	Epithelial
TATGTTCTCAAGCCCG-1	Epithelial
TATGTTCTCAAGTTGC-1	Epithelial
TATGTTCTCCACTGGG-1	Fibroblasts
TATTCCAAGCTGCCTG-1	Epithelial
TATTCCAAGCTTTCTT-1	Fibroblasts
TATTCCAAGTGCCGAA-1	Fibroblasts
TATTCCAAGTGGACGT-1	Epithelial
TATTCCACAATACCTG-1	Myofibroblast_Mesothelium
TATTCCACATCGGATT-1	Epithelial
TATTCCAGTGACTGTT-1	Muscle
TATTCCAGTGTCCGGT-1	Endothelial
TATTCCAGTGTTGATC-1	Fibroblasts
TATTGCTAGCAACTTC-1	Myofibroblast_Mesothelium
TATTGCTCATGTGCCG-1	Fibroblasts
TATTGCTTCCATAGAC-1	Fibroblasts
TATTGCTTCTAGATCG-1	Neural
TATTGCTTCTTTCTAG-1	Fibroblasts
TATTGGGAGAAATCCA-1	Epithelial
TATTGGGCACGTATAC-1	Epithelial
TATTGGGGTGTCATTG-1	Pericytes
TATTTCGAGAGAACCC-1	Myofibroblast_Mesothelium
TATTTCGAGGGTATAT-1	Neural
TATTTCGCACTTGTGA-1	Fibroblasts
TATTTCGCATTGCAAC-1	Epithelial
TATTTCGTCAAGGTGG-1	Immune
TATTTCGTCGCAGTGC-1	Epithelial
TATTTCGTCTGTAACG-1	Neural
TCAAGACCAAGTGATA-1	Endothelial
TCAAGACTCAGCTAGT-1	Epithelial
TCAAGACTCCGCGGAT-1	Myofibroblast_Mesothelium
TCAAGCAAGATAGTGT-1	Myofibroblast_Mesothelium
TCAAGCAGTAGCTAAA-1	Fibroblasts
TCAAGCAGTATCGTAC-1	Fibroblasts
TCAAGCAGTCAGTTTG-1	Epithelial
TCAAGCATCTCTGACC-1	Pericytes
TCAAGCATCTTCTCAA-1	Immune
TCAAGTGAGTCCTGCG-1	Pericytes
TCAAGTGCACGTATAC-1	Muscle
TCAAGTGCATCCTGTC-1	Fibroblasts
TCAAGTGGTGAGATAT-1	Epithelial
TCAAGTGTCGTGTGAT-1	Endothelial
TCAATCTCACTAGTAC-1	Pericytes
TCAATTCAGTCCTGTA-1	Epithelial
TCAATTCCAGCCGTCA-1	Muscle
TCAATTCGTACGACAG-1	Endothelial
TCAATTCTCATGGTAC-1	Pericytes
TCAATTCTCGTAATGC-1	Epithelial
TCACAAGAGCGCTTCG-1	Epithelial
TCACAAGAGTAATTGG-1	Pericytes
TCACAAGCAAAGCTCT-1	Fibroblasts
TCACAAGCATAAGCGG-1	Pericytes
TCACACCAGCTGAGTG-1	Myofibroblast_Mesothelium
TCACACCCACGCTGAC-1	Neural
TCACACCCACTGAGGA-1	Myofibroblast_Mesothelium
TCACACCCAGTGGCTC-1	Fibroblasts
TCACACCTCGCAATTG-1	Myofibroblast_Mesothelium
TCACACCTCTCATTGT-1	Pericytes
TCACATTTCTTACACT-1	Neural
TCACGCTAGGGAGAAT-1	Epithelial
TCACGCTCAGCGTTGC-1	Epithelial
TCACGCTCAGTTAAAG-1	Neural
TCACGCTGTATATGGA-1	Fibroblasts
TCACGCTGTTATGGTC-1	Myofibroblast_Mesothelium
TCACGCTTCGGTGTAT-1	Myofibroblast_Mesothelium
TCACGGGAGAAGGATG-1	Fibroblasts
TCACGGGAGGTAGCCA-1	Endothelial
TCACGGGCAGTATGAA-1	Endothelial
TCACGGGGTTTACACG-1	Neural
TCACTATCAAGTGGGT-1	Myofibroblast_Mesothelium
TCACTATCACACGGAA-1	Fibroblasts
TCACTATCACATGACT-1	Pericytes
TCACTATCATGCCGGT-1	Fibroblasts
TCACTATGTAGTGTGG-1	Epithelial
TCACTATGTATGTGTC-1	Epithelial
TCACTATGTGACTCGC-1	Muscle
TCACTATTCAAACCCA-1	Epithelial
TCACTATTCCGATTAG-1	Fibroblasts
TCACTATTCGAGTACT-1	Myofibroblast_Mesothelium
TCACTATTCTCTCAAT-1	Myofibroblast_Mesothelium
TCACTCGAGTGCAGGT-1	Fibroblasts
TCACTCGTCAATCCAG-1	Muscle
TCACTCGTCGCCAATA-1	Endothelial
TCACTCGTCGCTGATA-1	Epithelial
TCACTCGTCTTCCAGC-1	Pericytes
TCAGCAAGTTAGAGTA-1	Fibroblasts
TCAGCAATCTGTCTCG-1	Epithelial
TCAGCCTAGATAACGT-1	Fibroblasts
TCAGCCTCAGGGTCTC-1	Fibroblasts
TCAGCCTGTAACGATA-1	Myofibroblast_Mesothelium
TCAGCCTGTAGCTCGC-1	Pericytes
TCAGCCTGTGTGGTCC-1	Fibroblasts
TCAGCCTTCACGATCA-1	Myofibroblast_Mesothelium
TCAGCCTTCGCTGATA-1	Epithelial
TCAGCCTTCTGGGATT-1	Fibroblasts
TCAGGGCAGGCCTTCG-1	Myofibroblast_Mesothelium
TCAGGGCCACTGAGGA-1	Myofibroblast_Mesothelium
TCAGGGCCATACCATG-1	Endothelial
TCAGGGCGTACCTGTA-1	Epithelial
TCAGGGCGTATGTCCA-1	Fibroblasts
TCAGGGCTCAACCTTT-1	Neural
TCAGGGCTCATCGCCT-1	Epithelial
TCAGGGCTCTTGATTC-1	Fibroblasts
TCAGGTAAGCAAATGT-1	Epithelial
TCAGGTACACGTGTGC-1	Fibroblasts
TCAGGTACATAACGGG-1	Fibroblasts
TCAGGTAGTGCCCACA-1	Fibroblasts
TCAGGTATCACCGCTT-1	Neural
TCAGGTATCTTCGTGC-1	Epithelial
TCAGTCCCAGGCGAAT-1	Endothelial
TCAGTCCCATCCGTGG-1	Myofibroblast_Mesothelium
TCAGTCCCATTGAAAG-1	Neural
TCAGTCCGTCGACTGC-1	Immune
TCAGTGAAGGGAGTTC-1	Immune
TCAGTGAGTATGACAA-1	Fibroblasts
TCAGTGATCGCCTAGG-1	Epithelial
TCAGTTTAGGAGGTTC-1	Fibroblasts
TCAGTTTTCAAACCTG-1	Fibroblasts
TCAGTTTTCATTGCGA-1	Endothelial
TCAGTTTTCTCTCTTC-1	Epithelial
TCATACTAGTTAGTGA-1	Fibroblasts
TCATACTCAACAAGAT-1	Muscle
TCATACTCATGAAAGT-1	Myofibroblast_Mesothelium
TCATACTGTAACATGA-1	Pericytes
TCATATCCAACCACGC-1	Epithelial
TCATATCCAGAGGTTG-1	Epithelial
TCATATCCAGTCGAGA-1	Fibroblasts
TCATATCCATATCGGT-1	Myofibroblast_Mesothelium
TCATATCGTAACTTCG-1	Fibroblasts
TCATATCGTTCGATTG-1	Neural
TCATATCGTTTATGCG-1	Myofibroblast_Mesothelium
TCATATCTCAACACCA-1	Epithelial
TCATCATAGACCAGCA-1	Myofibroblast_Mesothelium
TCATCATCAAGATTGA-1	Epithelial
TCATCATCATGGAATA-1	Pericytes
TCATCATGTGAGAGGG-1	Epithelial
TCATCATTCGGAATGG-1	Epithelial
TCATCCGAGCCTATTG-1	Epithelial
TCATCCGAGTCGAGGT-1	Fibroblasts
TCATCCGCAGCCATTA-1	Epithelial
TCATCCGCATCCGTTC-1	Muscle
TCATCCGCATTAGGAA-1	Endothelial
TCATCCGGTCCCTGTT-1	Pericytes
TCATCCGTCCTTATAC-1	Fibroblasts
TCATGAGAGACAGCGT-1	Fibroblasts
TCATGAGAGAGTCGAC-1	Fibroblasts
TCATGAGAGTACTGGG-1	Endothelial
TCATGAGGTCAAAGAT-1	Neural
TCATGAGGTGATGTAA-1	Epithelial
TCATGAGGTGCTAGCC-1	Myofibroblast_Mesothelium
TCATGAGTCACTGTTT-1	Endothelial
TCATGAGTCGAGTCTA-1	Pericytes
TCATGCCAGTGCTAGG-1	Fibroblasts
TCATGCCCATGACTTG-1	Fibroblasts
TCATGCCGTAAGATAC-1	Epithelial
TCATGCCGTTTGGAAA-1	Epithelial
TCATGCCTCCAAGGGA-1	Myofibroblast_Mesothelium
TCATGGAAGCAAACAT-1	Epithelial
TCATGGAAGCACCTGC-1	Fibroblasts
TCATGGAAGCATCAAA-1	Epithelial
TCATGGACATGGGTCC-1	Fibroblasts
TCATGTTAGTGGAAGA-1	Immune
TCATGTTCAATTGGTC-1	Fibroblasts
TCATGTTCAGTAACCT-1	Epithelial
TCATGTTCAGTAGAAT-1	Fibroblasts
TCATGTTGTATCTTCT-1	Myofibroblast_Mesothelium
TCATGTTGTCCGGTCA-1	Pericytes
TCATGTTGTCGTCTCT-1	Neural
TCATGTTTCCAGCACG-1	Neural
TCATGTTTCGTTCCTG-1	Neural
TCATTACAGGTTGTTC-1	Pericytes
TCATTACGTGAGCCAA-1	Fibroblasts
TCATTACTCATTCGGA-1	Epithelial
TCATTCACATGACTGT-1	Endothelial
TCATTCATCACTTCTA-1	Fibroblasts
TCATTCATCTAGGCAT-1	Fibroblasts
TCATTGTAGGAGAGTA-1	Fibroblasts
TCATTGTCAACCGCCA-1	Myofibroblast_Mesothelium
TCATTGTCAGATCATC-1	Muscle
TCATTGTCAGGAATAT-1	Fibroblasts
TCATTGTTCGTTATCT-1	Muscle
TCATTTGAGTAGGGTC-1	Myofibroblast_Mesothelium
TCATTTGTCGGTGTAT-1	Pericytes
TCCACCAAGATCGGTG-1	Fibroblasts
TCCACCAAGGATTTAG-1	Epithelial
TCCACCAAGGATTTCC-1	Fibroblasts
TCCACCACACCAGTTA-1	Fibroblasts
TCCACCACACCGTCGA-1	Fibroblasts
TCCACCACATGGATCT-1	Fibroblasts
TCCACCAGTAAGTCAA-1	Epithelial
TCCACCAGTGAATGAT-1	Neural
TCCACCAGTGAGTAGC-1	Fibroblasts
TCCACCAGTGCGGCTT-1	Epithelial
TCCACGTCATTCACAG-1	Fibroblasts
TCCACGTGTTGTCCCT-1	Myofibroblast_Mesothelium
TCCACGTTCACTCGAA-1	Fibroblasts
TCCAGAAAGGTCGTGA-1	Fibroblasts
TCCAGAAAGTGCAACG-1	Neural
TCCAGAAGTCTTGCTC-1	Endothelial
TCCAGAATCCCGGTAG-1	Myofibroblast_Mesothelium
TCCATCGAGACTCAAA-1	Epithelial
TCCATCGCAAGGCGTA-1	Neural
TCCATCGGTAATCAAG-1	Immune
TCCATCGTCTTCGATT-1	Fibroblasts
TCCATGCAGGACTAAT-1	Fibroblasts
TCCATGCCAAATGAAC-1	Endothelial
TCCATGCCACACGGAA-1	Epithelial
TCCATGCCACCTGCAG-1	Epithelial
TCCATGCCACGACGTC-1	Endothelial
TCCATGCCATATTCGG-1	Fibroblasts
TCCATGCGTGAACCGA-1	Fibroblasts
TCCATGCTCACACCGG-1	Fibroblasts
TCCATGCTCTGTAACG-1	Myofibroblast_Mesothelium
TCCATGCTCTTCGTAT-1	Endothelial
TCCCACACAATAAGGT-1	Epithelial
TCCCACATCTTTCAGT-1	Epithelial
TCCCAGTCAACCGACC-1	Pericytes
TCCCAGTCAGGTTTAC-1	Fibroblasts
TCCCAGTGTCACCTTC-1	Endothelial
TCCCAGTTCACCTGTC-1	Muscle
TCCCATGAGGCACCAA-1	Neural
TCCCATGAGGTGGCTA-1	Pericytes
TCCCATGGTAGAGACC-1	Fibroblasts
TCCCATGTCCACGAAT-1	Fibroblasts
TCCGAAAAGATCCTAC-1	Epithelial
TCCGAAACACATGAAA-1	Epithelial
TCCGAAACACCAGACC-1	Fibroblasts
TCCGATCAGTACTCGT-1	Epithelial
TCCGATCAGTAGAATC-1	Fibroblasts
TCCGATCAGTGCTCGC-1	Fibroblasts
TCCGATCCAAGGTCGA-1	Epithelial
TCCGATCGTCGCAACC-1	Endothelial
TCCGATCTCAAAGGTA-1	Endothelial
TCCGATCTCCGTATGA-1	Endothelial
TCCGATCTCGGTCACG-1	Fibroblasts
TCCGGGAAGAGTTGCG-1	Immune
TCCGGGATCAGGACAG-1	Epithelial
TCCGGGATCGTTAGTG-1	Neural
TCCGGGATCTAACACG-1	Epithelial
TCCGGGATCTCCATAT-1	Epithelial
TCCGTGTCACATATGC-1	Pericytes
TCCGTGTCATAGCACT-1	Epithelial
TCCGTGTCATTCGGGC-1	Epithelial
TCCGTGTGTCCACTCT-1	Fibroblasts
TCCTAATGTATGAAGT-1	Immune
TCCTAATTCCCAGCGA-1	Myofibroblast_Mesothelium
TCCTCCCAGCCTAACT-1	Epithelial
TCCTCCCAGCCTCTTC-1	Fibroblasts
TCCTCCCAGGTTGGAC-1	Fibroblasts
TCCTCCCCATGAGGGT-1	Myofibroblast_Mesothelium
TCCTCCCGTCCGGTCA-1	Fibroblasts
TCCTCCCGTGCCCTTT-1	Epithelial
TCCTCCCGTTGGACTT-1	Endothelial
TCCTCCCGTTTCGATG-1	Muscle
TCCTCCCTCACATTGG-1	Epithelial
TCCTCGAAGAGCAACC-1	Muscle
TCCTCGACAATCGCGC-1	Immune
TCCTCGACATGTCAGT-1	Muscle
TCCTCTTAGACCAAGC-1	Fibroblasts
TCCTCTTGTGTTAGCT-1	Epithelial
TCCTCTTTCCAGTGCG-1	Fibroblasts
TCCTCTTTCCCGAGAC-1	Fibroblasts
TCCTCTTTCTAGCCTC-1	Fibroblasts
TCCTGCAAGCCTTTCC-1	Epithelial
TCCTGCAAGCGATTCT-1	Myofibroblast_Mesothelium
TCCTGCACATGACAAA-1	Myofibroblast_Mesothelium
TCCTGCAGTCCAGCAC-1	Fibroblasts
TCCTGCAGTTGCATGT-1	Neural
TCCTGCATCCACGTGG-1	Pericytes
TCCTGCATCGTCGACG-1	Myofibroblast_Mesothelium
TCCTTCTAGAAACCCG-1	Fibroblasts
TCCTTCTAGATTCGAA-1	Fibroblasts
TCCTTCTCAAACCATC-1	Neural
TCCTTCTCAGTAGAAT-1	Fibroblasts
TCCTTCTGTGCCTAAT-1	Neural
TCCTTCTGTTGTAAAG-1	Myofibroblast_Mesothelium
TCCTTTCAGAGCAAGA-1	Fibroblasts
TCCTTTCGTACAGAGC-1	Fibroblasts
TCCTTTCGTATACCCA-1	Fibroblasts
TCCTTTCTCATCGACA-1	Epithelial
TCCTTTCTCCGGACGT-1	Fibroblasts
TCCTTTCTCTCTGAGA-1	Epithelial
TCGAACAAGACCAGCA-1	Muscle
TCGAACAGTGCATCTA-1	Fibroblasts
TCGAACATCGAAGGAC-1	Fibroblasts
TCGAAGTTCCCTGGTT-1	Fibroblasts
TCGACCTAGGATAATC-1	Epithelial
TCGACGGCACGCGTGT-1	Muscle
TCGACGGCAGAGCGTA-1	Epithelial
TCGACGGTCTGGTCAA-1	Muscle
TCGACGGTCTTAGTTC-1	Pericytes
TCGATTTAGATTAGCA-1	Endothelial
TCGATTTCAGTCAGCC-1	Myofibroblast_Mesothelium
TCGATTTTCCCTTGGT-1	Epithelial
TCGATTTTCTTAGGAC-1	Fibroblasts
TCGCACTAGACATGCG-1	Epithelial
TCGCACTAGAGCCTGA-1	Fibroblasts
TCGCACTCAGCGTGAA-1	Myofibroblast_Mesothelium
TCGCACTTCCCAAGTA-1	Epithelial
TCGCACTTCGGAATGG-1	Epithelial
TCGCAGGCATATCGGT-1	Epithelial
TCGCAGGGTTAAAGTG-1	Epithelial
TCGCAGGGTTATAGCC-1	Epithelial
TCGCAGGTCTGAGTCA-1	Pericytes
TCGCTCAAGTAGTCCT-1	Epithelial
TCGCTCACACGTAGTT-1	Fibroblasts
TCGCTCACAGAGAAAG-1	Epithelial
TCGCTTGAGCTGAGCA-1	Fibroblasts
TCGCTTGCAGTACTAC-1	Myofibroblast_Mesothelium
TCGCTTGCATGACACT-1	Endothelial
TCGCTTGCATTCTGTT-1	Endothelial
TCGCTTGCATTGAGCT-1	Epithelial
TCGCTTGTCGCTTGCT-1	Fibroblasts
TCGGATAAGACTACCT-1	Neural
TCGGATAAGTCGAAAT-1	Muscle
TCGGATACACTCTGCT-1	Pericytes
TCGGATACAGAGATTA-1	Epithelial
TCGGATAGTATGGTAA-1	Fibroblasts
TCGGATAGTTGTGTTG-1	Epithelial
TCGGATATCGCTACGG-1	Epithelial
TCGGGACAGTTAGTAG-1	Endothelial
TCGGGACGTTCGTACA-1	Myofibroblast_Mesothelium
TCGGGACTCTACAGGT-1	Fibroblasts
TCGGGCAAGGAAAGTG-1	Epithelial
TCGGGCACAATCTCGA-1	Epithelial
TCGGGCACATCCTTCG-1	Fibroblasts
TCGGGCAGTAGTGATA-1	Neural
TCGGGCATCAGCTGAT-1	Fibroblasts
TCGGTCTCAAGACCTT-1	Epithelial
TCGGTCTGTTACCCTC-1	Epithelial
TCGGTCTGTTATGACC-1	Muscle
TCGGTCTTCCTGCCAT-1	Immune
TCGTAGAGTTCTCGTC-1	Pericytes
TCGTAGATCTAGGCCG-1	Myofibroblast_Mesothelium
TCGTAGATCTCTGCCA-1	Muscle
TCGTCCACACCCAATA-1	Epithelial
TCGTCCACAGAGTTGG-1	Epithelial
TCGTCCACAGGGTTGA-1	Epithelial
TCGTCCAGTTAAGAAC-1	Epithelial
TCGTCCATCCTCATAT-1	Fibroblasts
TCGTGCTAGCCAGACA-1	Myofibroblast_Mesothelium
TCGTGCTAGTCTGTAC-1	Epithelial
TCGTGCTCAACCACAT-1	Immune
TCGTGCTCAAGCCTGC-1	Epithelial
TCGTGCTCAGGATGAC-1	Epithelial
TCGTGCTTCGCTTTAT-1	Epithelial
TCGTGGGAGAGAGTTT-1	Myofibroblast_Mesothelium
TCGTGGGAGTACAGAT-1	Fibroblasts
TCGTGGGGTCCGGTGT-1	Fibroblasts
TCTAACTTCAGACAAA-1	Neural
TCTACATCATACCACA-1	Fibroblasts
TCTACATCATAGATCC-1	Pericytes
TCTACATGTAGCTGAG-1	Epithelial
TCTACATGTTCCATTT-1	Fibroblasts
TCTACCGCACCTCAGG-1	Neural
TCTACCGGTGGATCAG-1	Fibroblasts
TCTACCGGTTCTCGTC-1	Epithelial
TCTACCGTCGCTAATG-1	Epithelial
TCTACCGTCTCTGCTG-1	Fibroblasts
TCTACCGTCTGCTCTG-1	Epithelial
TCTATACAGATTCGAA-1	Epithelial
TCTATACAGCGGACAT-1	Fibroblasts
TCTATACGTACCTATG-1	Fibroblasts
TCTATACTCTGAGCAT-1	Neural
TCTATCAAGACGAGCT-1	Epithelial
TCTATCAGTCAAGCCC-1	Myofibroblast_Mesothelium
TCTATCAGTGCAACGA-1	Epithelial
TCTATCAGTGCATACT-1	Fibroblasts
TCTATCAGTGCGTGCT-1	Fibroblasts
TCTATCATCGTCTAAG-1	Epithelial
TCTCACGAGGATAATC-1	Fibroblasts
TCTCACGCAAATGGCG-1	Fibroblasts
TCTCACGCAATAGTCC-1	Immune
TCTCACGCATACCACA-1	Pericytes
TCTCACGGTGGACTAG-1	Fibroblasts
TCTCAGCCAGAAGCTG-1	Epithelial
TCTCAGCGTCACTCGG-1	Fibroblasts
TCTCAGCTCGAGAATA-1	Immune
TCTCCGATCCTGCCAT-1	Muscle
TCTCCGATCCTTGACC-1	Fibroblasts
TCTCCGATCTAAGGAA-1	Fibroblasts
TCTCTGGAGAGGTCAC-1	Neural
TCTGCCAAGTTGGCGA-1	Fibroblasts
TCTGCCACAGCAGGAT-1	Epithelial
TCTGCCAGTACCGTCG-1	Neural
TCTGCCAGTCAAGGCA-1	Myofibroblast_Mesothelium
TCTGCCAGTCGAGTGA-1	Epithelial
TCTGCCAGTCTTGGTA-1	Pericytes
TCTGGCTAGTCACACT-1	Fibroblasts
TCTGGCTCACGAGAAC-1	Epithelial
TCTGGCTCAGCTATAC-1	Fibroblasts
TCTGGCTCATCGCCTT-1	Endothelial
TCTGGCTGTACGACAG-1	Fibroblasts
TCTGGCTGTGGCCACT-1	Fibroblasts
TCTGGCTGTTTGTGGT-1	Fibroblasts
TCTGGCTTCAAGTGTC-1	Endothelial
TCTGGCTTCGGATACT-1	Epithelial
TCTGGCTTCTTCTGTA-1	Fibroblasts
TCTGTCGAGCCTGTGC-1	Epithelial
TCTGTCGGTGCAAGAC-1	Fibroblasts
TCTGTCGGTGCGAACA-1	Myofibroblast_Mesothelium
TCTGTCGGTGGCAACA-1	Pericytes
TCTGTCGTCACCGGGT-1	Immune
TCTTAGTCATTGGATC-1	Myofibroblast_Mesothelium
TCTTAGTGTCGCTGCA-1	Endothelial
TCTTAGTTCTTAATCC-1	Epithelial
TCTTCCTAGAGTCAAT-1	Neural
TCTTCCTAGCATCAGG-1	Epithelial
TCTTCCTAGTCATCCA-1	Pericytes
TCTTCCTAGTCGGGAT-1	Neural
TCTTCCTGTATTGGCT-1	Fibroblasts
TCTTCCTGTCAGACTT-1	Epithelial
TCTTCCTGTGCGAACA-1	Neural
TCTTCCTTCTGGTCAA-1	Pericytes
TCTTGCGAGCGTCAGA-1	Epithelial
TCTTGCGCAGCTGTGC-1	Fibroblasts
TCTTGCGCATCACCAA-1	Myofibroblast_Mesothelium
TCTTGCGGTTCTCCAC-1	Neural
TCTTGCGTCCGCTTAC-1	Myofibroblast_Mesothelium
TCTTGCGTCCTCAGGG-1	Fibroblasts
TCTTTGAAGACGACTG-1	Endothelial
TCTTTGAAGGAACGAA-1	Epithelial
TCTTTGAAGTGGCCTC-1	Fibroblasts
TCTTTGAGTGGACAGT-1	Fibroblasts
TCTTTGATCACAAGGG-1	Epithelial
TCTTTGATCGAGAGAC-1	Fibroblasts
TGAACGTCAATGGGTG-1	Epithelial
TGAACGTCAATTAGGA-1	Epithelial
TGAACGTCATGGTACT-1	Epithelial
TGAACGTTCATAGGCT-1	Fibroblasts
TGAACGTTCGCTGCGA-1	Fibroblasts
TGAATCGAGCAAGGAA-1	Endothelial
TGAATCGAGCTATCCA-1	Endothelial
TGAATCGAGCTATCTG-1	Pericytes
TGAATCGAGGGTATAT-1	Fibroblasts
TGAATCGAGGTCCAGA-1	Epithelial
TGAATCGCAGTCAACT-1	Pericytes
TGAATCGGTGATGTAA-1	Epithelial
TGAATCGTCAATCGGT-1	Fibroblasts
TGAATCGTCTGCCCTA-1	Fibroblasts
TGAATCGTCTGGGTCG-1	Fibroblasts
TGAATGCAGTCGCCAC-1	Fibroblasts
TGAATGCAGTGGACGT-1	Pericytes
TGAATGCGTATGGTTC-1	Epithelial
TGAATGCGTGGCAGAT-1	Epithelial
TGAATGCGTTTCACAG-1	Epithelial
TGAATGCTCTCCCATG-1	Epithelial
TGAATGCTCTGCGGGT-1	Fibroblasts
TGACAGTCAGGCTACC-1	Epithelial
TGACAGTTCTCAAAGC-1	Myofibroblast_Mesothelium
TGACCCTAGTATTGCC-1	Fibroblasts
TGACCCTTCATTGCTT-1	Fibroblasts
TGACCCTTCCCGAATA-1	Epithelial
TGACCCTTCGTGAGAG-1	Neural
TGACCCTTCTGTCAGA-1	Fibroblasts
TGACGCGAGGTAAGGA-1	Immune
TGACGCGCATCCCACT-1	Muscle
TGACGCGGTGAAGCGT-1	Fibroblasts
TGACTCCAGGTAAGGA-1	Epithelial
TGACTCCCAACAAGAT-1	Myofibroblast_Mesothelium
TGACTCCCAATCCTAG-1	Fibroblasts
TGACTCCGTCGTGATT-1	Epithelial
TGAGACTAGATTCGAA-1	Epithelial
TGAGACTAGTGGACGT-1	Epithelial
TGAGACTCAACTCATG-1	Neural
TGAGACTCAATGGGTG-1	Fibroblasts
TGAGACTGTATGAAGT-1	Myofibroblast_Mesothelium
TGAGACTGTCACCGAC-1	Epithelial
TGAGACTGTCAGTCGC-1	Epithelial
TGAGCATAGAGGTCGT-1	Pericytes
TGAGCATAGTGCACAG-1	Neural
TGAGCATCACCGGCTA-1	Muscle
TGAGCATCATCGCTAA-1	Neural
TGAGCGCCACATCATG-1	Epithelial
TGAGCGCCACGCAAAG-1	Endothelial
TGAGCGCCATATGCGT-1	Immune
TGAGCGCGTTAGGAGC-1	Endothelial
TGAGCGCTCCGTATGA-1	Myofibroblast_Mesothelium
TGAGGAGAGACCCGCT-1	Pericytes
TGAGGAGCACAGTCAT-1	Neural
TGAGGAGGTCAAAGAT-1	Epithelial
TGAGGAGGTGTCATCA-1	Fibroblasts
TGAGGGAAGCCAAGGT-1	Fibroblasts
TGAGGGAAGGGTTTCT-1	Immune
TGAGGGACAACCAGAG-1	Muscle
TGAGGGACAGTTACCA-1	Myofibroblast_Mesothelium
TGAGGGACATATGCGT-1	Epithelial
TGAGGGAGTAATTGGA-1	Epithelial
TGAGGGATCCGATCGG-1	Myofibroblast_Mesothelium
TGAGGGATCCTACGAA-1	Myofibroblast_Mesothelium
TGAGGTTCAAGGGCAT-1	Fibroblasts
TGAGGTTCAATCTGCA-1	Fibroblasts
TGAGGTTCACTGGCGT-1	Immune
TGAGGTTCATTCTCTA-1	Fibroblasts
TGAGGTTTCTTACACT-1	Pericytes
TGAGGTTTCTTCACAT-1	Fibroblasts
TGAGTCAAGCGTCGAA-1	Epithelial
TGAGTCAAGGCTCTCG-1	Pericytes
TGAGTCAAGGTCATCT-1	Pericytes
TGAGTCAAGGTGATCG-1	Fibroblasts
TGAGTCACAACTCCCT-1	Myofibroblast_Mesothelium
TGAGTCAGTAGCGTTT-1	Fibroblasts
TGAGTCATCGCAACAT-1	Fibroblasts
TGAGTCATCTATCACT-1	Fibroblasts
TGATCAGAGATGTTAG-1	Myofibroblast_Mesothelium
TGATCAGAGGAATTAC-1	Fibroblasts
TGATCAGAGGGCCCTT-1	Fibroblasts
TGATCAGAGGGTTAGC-1	Fibroblasts
TGATCAGCATCTGCGG-1	Myofibroblast_Mesothelium
TGATCAGGTAAGTAGT-1	Myofibroblast_Mesothelium
TGATCAGGTGTGTGGA-1	Myofibroblast_Mesothelium
TGATCAGTCGCGTGAC-1	Fibroblasts
TGATCTTAGGCAGGGA-1	Epithelial
TGATCTTAGTCATGGG-1	Fibroblasts
TGATCTTCACCAGTTA-1	Muscle
TGATCTTCAGCCCACA-1	Epithelial
TGATCTTTCTGCAGCG-1	Immune
TGATGCAAGATACCAA-1	Endothelial
TGATGCAAGCTCTATG-1	Endothelial
TGATGCACACACTGGC-1	Endothelial
TGATGCACATCTCAAG-1	Muscle
TGATGCAGTAAGATAC-1	Endothelial
TGATGGTAGAGTTGCG-1	Muscle
TGATGGTAGTATGCAA-1	Fibroblasts
TGATGGTAGTCGAATA-1	Epithelial
TGATGGTGTAGGAGTC-1	Epithelial
TGATGGTTCCGTCACT-1	Fibroblasts
TGATGGTTCGGAATGG-1	Epithelial
TGATTCTAGACCACGA-1	Fibroblasts
TGATTCTCAGCGCTTG-1	Epithelial
TGATTCTTCCATTTAC-1	Myofibroblast_Mesothelium
TGATTTCAGGAGACCT-1	Epithelial
TGATTTCAGTACGAGC-1	Epithelial
TGATTTCCATAAGCGG-1	Fibroblasts
TGATTTCGTGACAGGT-1	Myofibroblast_Mesothelium
TGATTTCTCATGGATC-1	Epithelial
TGCACGGAGCTTCATG-1	Endothelial
TGCACGGCACTAACGT-1	Endothelial
TGCACGGTCAAATGCC-1	Epithelial
TGCACGGTCGATTGAC-1	Fibroblasts
TGCAGATAGACTACCT-1	Pericytes
TGCAGATCAAGGCAAC-1	Fibroblasts
TGCAGATCATAGGTAA-1	Fibroblasts
TGCAGATTCGAACGCC-1	Myofibroblast_Mesothelium
TGCAGATTCGTCTCAC-1	Fibroblasts
TGCAGATTCTACTCAT-1	Fibroblasts
TGCAGGCAGATAGCTA-1	Myofibroblast_Mesothelium
TGCAGGCCAGAAGTGC-1	Fibroblasts
TGCAGGCCAGTCGTTA-1	Fibroblasts
TGCAGGCCAGTGGTGA-1	Fibroblasts
TGCAGGCGTCTTCGAA-1	Fibroblasts
TGCAGGCTCGGCGATC-1	Pericytes
TGCAGTAAGCAAACAT-1	Epithelial
TGCAGTACAAGGCCTC-1	Endothelial
TGCAGTAGTGTGTCGC-1	Pericytes
TGCATCCGTATGCGGA-1	Fibroblasts
TGCATCCTCCTACACC-1	Fibroblasts
TGCATGAGTGGTCTCG-1	Epithelial
TGCATGATCAGCTGAT-1	Fibroblasts
TGCATGATCATGCCAA-1	Myofibroblast_Mesothelium
TGCCGAGAGACGCCAA-1	Myofibroblast_Mesothelium
TGCCGAGAGGATCACG-1	Neural
TGCCGAGAGGTTCCAT-1	Myofibroblast_Mesothelium
TGCCGAGAGTCCCTAA-1	Myofibroblast_Mesothelium
TGCCGAGCATGGGTCC-1	Myofibroblast_Mesothelium
TGCCGAGCATTGAAAG-1	Fibroblasts
TGCCGAGGTAACATAG-1	Fibroblasts
TGCCGAGGTGGCCACT-1	Fibroblasts
TGCCGAGTCGTGGAAG-1	Epithelial
TGCGACGAGCACCAGA-1	Myofibroblast_Mesothelium
TGCGACGCAGCGGTTC-1	Pericytes
TGCGACGGTTTCGCTC-1	Pericytes
TGCGACGTCGTCGACG-1	Myofibroblast_Mesothelium
TGCGATAAGGGATCTG-1	Myofibroblast_Mesothelium
TGCGATACAAGGAGTC-1	Myofibroblast_Mesothelium
TGCGATACAGCGCGTT-1	Endothelial
TGCGATATCGCGCCAA-1	Epithelial
TGCGATATCGTGCAGC-1	Epithelial
TGCGGCAAGCAGGCAT-1	Fibroblasts
TGCGGCAAGTTAACAG-1	Fibroblasts
TGCGGCACAATACCCA-1	Epithelial
TGCGGCACATACCAGT-1	Epithelial
TGCGGCAGTAGCTCGC-1	Fibroblasts
TGCGGCAGTCTTTATC-1	Epithelial
TGCGGCAGTGACACAG-1	Epithelial
TGCGGCATCGTAGGGA-1	Epithelial
TGCGGCATCTGGGATT-1	Fibroblasts
TGCGGCATCTTCTGTA-1	Myofibroblast_Mesothelium
TGCGGGTAGAAACCCG-1	Immune
TGCGGGTTCACGATAC-1	Epithelial
TGCGGGTTCGTGTCAA-1	Immune
TGCTCCAAGCGTTCAT-1	Pericytes
TGCTCCACACAAGCTT-1	Epithelial
TGCTCCACACTGCTTC-1	Fibroblasts
TGCTCCATCATTCATC-1	Myofibroblast_Mesothelium
TGCTCCATCTGATGGT-1	Myofibroblast_Mesothelium
TGCTCGTAGCGGACAT-1	Epithelial
TGCTCGTCAGAATTCC-1	Fibroblasts
TGCTCGTCAGCTATAC-1	Fibroblasts
TGCTCGTCAGTCAGAG-1	Myofibroblast_Mesothelium
TGCTCGTGTGTCTCCT-1	Fibroblasts
TGCTCGTGTTGTCTAG-1	Neural
TGCTGAAAGGAACGCT-1	Fibroblasts
TGCTGAACACAGCATT-1	Fibroblasts
TGCTGAAGTATGGGAC-1	Neural
TGCTGAAGTATTCTCT-1	Pericytes
TGCTGAAGTTTGACAC-1	Neural
TGCTGAATCAGCGTCG-1	Endothelial
TGCTTCGAGCAAGTCG-1	Myofibroblast_Mesothelium
TGCTTCGAGCTGTGCC-1	Epithelial
TGCTTCGGTTAGAGTA-1	Epithelial
TGCTTGCAGAAGTCTA-1	Myofibroblast_Mesothelium
TGCTTGCAGCATTGTC-1	Epithelial
TGCTTGCAGCTCTATG-1	Fibroblasts
TGCTTGCCAATGACCT-1	Epithelial
TGCTTGCTCATCTACT-1	Neural
TGCTTGCTCGCAGATT-1	Muscle
TGCTTGCTCGCTAAAC-1	Fibroblasts
TGGAACTAGCCATCCG-1	Neural
TGGAACTAGCCGATAG-1	Fibroblasts
TGGAACTAGCGACCCT-1	Epithelial
TGGAACTAGTAAGCAT-1	Epithelial
TGGAACTCAATAAGGT-1	Fibroblasts
TGGAACTCATGGGTTT-1	Fibroblasts
TGGAACTGTTAGGGAC-1	Epithelial
TGGAACTTCAGCGCAC-1	Fibroblasts
TGGAACTTCCGAAATC-1	Fibroblasts
TGGAACTTCCTCAGAA-1	Myofibroblast_Mesothelium
TGGAGAGAGAGGGTGG-1	Fibroblasts
TGGAGAGAGATCCCGC-1	Epithelial
TGGAGAGAGCGGACAT-1	Muscle
TGGAGAGCAGACACAG-1	Epithelial
TGGAGAGCAGCTGCCA-1	Epithelial
TGGAGAGTCCGTATAG-1	Fibroblasts
TGGAGGACAAAGGCGT-1	Endothelial
TGGAGGATCCGTGGCA-1	Epithelial
TGGATCAAGCCATGCC-1	Epithelial
TGGATCAAGTAACAGT-1	Epithelial
TGGATCATCCTACGAA-1	Myofibroblast_Mesothelium
TGGATGTGTGATACAA-1	Fibroblasts
TGGATGTTCAAGTGTC-1	Pericytes
TGGATGTTCGGCTGAC-1	Endothelial
TGGATGTTCGTAGAGG-1	Epithelial
TGGCGTGCAAGTCGTT-1	Epithelial
TGGCGTGCATGTACGT-1	Epithelial
TGGCGTGGTAGACAGC-1	Immune
TGGCGTGGTTCCTAAG-1	Epithelial
TGGCGTGTCACGAGGA-1	Fibroblasts
TGGCGTGTCATTTGGG-1	Epithelial
TGGGAAGCACGCTGCA-1	Fibroblasts
TGGGAAGCACTCCCTA-1	Pericytes
TGGGAAGGTGGATGAC-1	Muscle
TGGGAAGGTTCCGCGA-1	Neural
TGGGAAGTCGCTTTAT-1	Muscle
TGGGAGACAATTGAGA-1	Epithelial
TGGGAGAGTACGAGCA-1	Fibroblasts
TGGGATTGTGGTCTGC-1	Fibroblasts
TGGGATTTCCAGTGTA-1	Muscle
TGGGATTTCTAGGAAA-1	Immune
TGGGCGTAGCCGTCGT-1	Muscle
TGGGCGTGTTATGGTC-1	Endothelial
TGGGCGTTCGGCACTG-1	Muscle
TGGGCTGAGGGACAGG-1	Muscle
TGGGTTAGTCTGTTAG-1	Myofibroblast_Mesothelium
TGGGTTAGTGACATCT-1	Endothelial
TGGGTTATCGAGCTGC-1	Fibroblasts
TGGGTTATCTGTTCAT-1	Myofibroblast_Mesothelium
TGGTACAAGAAGGCTC-1	Epithelial
TGGTACAAGTACTGGG-1	Epithelial
TGGTACACAGGCTCTG-1	Neural
TGGTACAGTAACGTTC-1	Myofibroblast_Mesothelium
TGGTACATCCGGTAGC-1	Endothelial
TGGTACATCTTGGGCG-1	Endothelial
TGGTAGTAGACTTAAG-1	Fibroblasts
TGGTAGTAGCAACTCT-1	Immune
TGGTAGTAGGCACTCC-1	Pericytes
TGGTAGTGTTATTCTC-1	Neural
TGGTAGTGTTCAGGTT-1	Epithelial
TGGTAGTTCCGCTGTT-1	Epithelial
TGGTAGTTCCTGCTAC-1	Neural
TGGTAGTTCGCGGACT-1	Endothelial
TGGTGATCAAGACAAT-1	Myofibroblast_Mesothelium
TGGTGATCAGCAGTGA-1	Fibroblasts
TGGTGATCAGCTTTGA-1	Endothelial
TGGTGATGTAGGGAGG-1	Pericytes
TGGTGATTCAAACCCA-1	Fibroblasts
TGGTGATTCCAAGCTA-1	Epithelial
TGGTGATTCGAGCCAC-1	Fibroblasts
TGTAACGAGGCCTAGA-1	Pericytes
TGTAACGCAGAGGAAA-1	Fibroblasts
TGTAACGCATATCTGG-1	Epithelial
TGTAACGCATGTTTGG-1	Fibroblasts
TGTAACGGTTATGTGC-1	Epithelial
TGTAACGTCGATGGAG-1	Myofibroblast_Mesothelium
TGTAAGCAGTGCAACG-1	Fibroblasts
TGTAAGCCAAATGCTC-1	Epithelial
TGTAAGCCAACACGAG-1	Myofibroblast_Mesothelium
TGTAAGCCAACCGACC-1	Epithelial
TGTAAGCCAGAGACTG-1	Epithelial
TGTAAGCCAGGACAGT-1	Fibroblasts
TGTAAGCCAGTAGGAC-1	Pericytes
TGTAAGCTCTCTGCTG-1	Pericytes
TGTAAGCTCTGTTCAT-1	Endothelial
TGTACAGAGGTTCAGG-1	Fibroblasts
TGTACAGCAATGTGGG-1	Fibroblasts
TGTACAGTCACCTCGT-1	Epithelial
TGTACAGTCCTAGCTC-1	Fibroblasts
TGTAGACCAAGAATGT-1	Myofibroblast_Mesothelium
TGTAGACCACGACGTC-1	Fibroblasts
TGTAGACCAGCCTACG-1	Pericytes
TGTAGACCATTCGGGC-1	Pericytes
TGTAGACGTTGCAACT-1	Epithelial
TGTAGACTCCTACCGT-1	Endothelial
TGTAGACTCTTCCTAA-1	Myofibroblast_Mesothelium
TGTCAGAAGGTAACTA-1	Epithelial
TGTCAGACACCACATA-1	Fibroblasts
TGTCAGAGTCCGTTTC-1	Myofibroblast_Mesothelium
TGTCAGATCGTCACCT-1	Muscle
TGTCCACAGCTGAGCA-1	Muscle
TGTCCACCAGGATCTT-1	Fibroblasts
TGTCCACGTACTCAAC-1	Myofibroblast_Mesothelium
TGTCCACGTTGACGGA-1	Fibroblasts
TGTCCACTCGCCCAGA-1	Endothelial
TGTCCCAAGATAGTCA-1	Fibroblasts
TGTCCCAAGATGCTTC-1	Epithelial
TGTCCCACACCAGGTC-1	Epithelial
TGTCCCACAGATTCGT-1	Fibroblasts
TGTCCTGAGGTGGGTT-1	Epithelial
TGTCCTGCATTCCTAT-1	Fibroblasts
TGTCCTGGTCTCGACG-1	Fibroblasts
TGTCCTGGTGATATAG-1	Muscle
TGTCCTGTCAGAGTGG-1	Immune
TGTCCTGTCGGTCGAC-1	Neural
TGTCCTGTCTTCTAAC-1	Pericytes
TGTGAGTCAAGTCATC-1	Endothelial
TGTGAGTTCTCAGTCC-1	Fibroblasts
TGTGAGTTCTCCTGCA-1	Neural
TGTGAGTTCTTAAGGC-1	Neural
TGTGAGTTCTTACGGA-1	Pericytes
TGTGATGCATTGCCGG-1	Endothelial
TGTGCGGAGATACCAA-1	Epithelial
TGTGCGGAGCATGTTC-1	Fibroblasts
TGTGCGGCACAATGCT-1	Epithelial
TGTGCGGGTAGGCTCC-1	Fibroblasts
TGTGCGGTCATATGGC-1	Fibroblasts
TGTGCGGTCTCAGGCG-1	Neural
TGTGGCGAGCTCCCTT-1	Pericytes
TGTGGCGAGGTTGACG-1	Fibroblasts
TGTGGCGAGTGGTGGT-1	Pericytes
TGTGGCGCATGACACT-1	Epithelial
TGTGGCGTCAGCCTTC-1	Pericytes
TGTGTGAAGACCAAGC-1	Fibroblasts
TGTGTGACAGCAGTTT-1	Fibroblasts
TGTGTGACATAACCCA-1	Fibroblasts
TGTGTGACATCAGCTA-1	Fibroblasts
TGTGTGAGTCGTGATT-1	Fibroblasts
TGTGTGAGTGGACAGT-1	Epithelial
TGTGTGATCAGAACCT-1	Neural
TGTGTGATCCAAGCAT-1	Fibroblasts
TGTTACTCAGCGATTT-1	Endothelial
TGTTCATAGGTCGTAG-1	Fibroblasts
TGTTCATAGTTGTAAG-1	Fibroblasts
TGTTCATCAATAGGGC-1	Epithelial
TGTTCATCAGACCATT-1	Muscle
TGTTCATTCATACAGC-1	Epithelial
TGTTCATTCCAAGGGA-1	Neural
TGTTCATTCGTGGCTG-1	Fibroblasts
TGTTCCGAGTAGCCAG-1	Epithelial
TGTTCCGCATAGCACT-1	Epithelial
TGTTCCGGTCACTCGG-1	Endothelial
TGTTCCGGTGTAAATG-1	Epithelial
TGTTCTAAGTCACAGG-1	Immune
TGTTCTAAGTGTTCCA-1	Muscle
TGTTCTACAAGTTTGC-1	Myofibroblast_Mesothelium
TGTTCTACACATGAAA-1	Epithelial
TGTTCTATCGACACCG-1	Epithelial
TGTTGAGAGATTGAGT-1	Epithelial
TGTTGAGAGTTTCGGT-1	Fibroblasts
TGTTGAGCATAACCCA-1	Epithelial
TGTTGAGCATTGAGCT-1	Muscle
TGTTGAGTCACGACTA-1	Immune
TGTTGAGTCTGGCCAG-1	Fibroblasts
TGTTGGAAGAATAACC-1	Epithelial
TGTTGGAAGAGTCACG-1	Fibroblasts
TGTTGGAAGCCGGATA-1	Epithelial
TGTTGGAAGGTGGTTG-1	Muscle
TGTTGGAAGGTTCATC-1	Fibroblasts
TGTTGGATCTGTCCCA-1	Epithelial
TGTTTGTGTGAAGCTG-1	Epithelial
TGTTTGTGTTCGGTTA-1	Endothelial
TTAATCCAGAAGGGAT-1	Fibroblasts
TTAATCCAGAGTCGAC-1	Fibroblasts
TTAATCCCACCAATTG-1	Myofibroblast_Mesothelium
TTAATCCCAGAGAGGG-1	Fibroblasts
TTAATCCCATCCTAAG-1	Pericytes
TTAATCCCATTATGCG-1	Fibroblasts
TTAATCCGTTAGTTCG-1	Fibroblasts
TTAATCCTCCACCTCA-1	Epithelial
TTACAGGAGAAAGTCT-1	Epithelial
TTACAGGAGCGACTTT-1	Pericytes
TTACAGGAGGCTAACG-1	Fibroblasts
TTACAGGAGTTCTACG-1	Fibroblasts
TTACAGGCAAACACGG-1	Fibroblasts
TTACAGGGTCCCTGAG-1	Epithelial
TTACAGGTCCAGCAAT-1	Fibroblasts
TTACCATAGACATACA-1	Muscle
TTACCATAGAGAGGGC-1	Epithelial
TTACCATAGGATGCGT-1	Muscle
TTACCATGTCATTGCA-1	Fibroblasts
TTACCATTCAGTGTCA-1	Muscle
TTACCGCAGCCACCGT-1	Fibroblasts
TTACCGCAGGACTGGT-1	Fibroblasts
TTACCGCCACAGAGCA-1	Epithelial
TTACCGCCACCCTAAA-1	Epithelial
TTACCGCTCACACCGG-1	Myofibroblast_Mesothelium
TTACGCCAGGAAGTGA-1	Neural
TTACGCCCACGTCTCT-1	Immune
TTACGCCCATGCGTGC-1	Fibroblasts
TTACGCCTCTTGAACG-1	Myofibroblast_Mesothelium
TTACGTTAGACGGAAA-1	Epithelial
TTACGTTAGTCTTCGA-1	Epithelial
TTACGTTAGTTGGCTT-1	Epithelial
TTACGTTCACAGCCTG-1	Epithelial
TTACGTTGTACAAGTA-1	Fibroblasts
TTACGTTTCTTAGGAC-1	Fibroblasts
TTACTGTCATTGAAAG-1	Pericytes
TTACTGTTCAGAACCT-1	Epithelial
TTACTGTTCAGATTGC-1	Neural
TTAGGCAAGCAGCCCT-1	Endothelial
TTAGGCACAGGTTCAT-1	Myofibroblast_Mesothelium
TTAGGCAGTTCTATCT-1	Epithelial
TTAGGGTAGAGCCGAT-1	Fibroblasts
TTAGGGTAGCCTAGGA-1	Fibroblasts
TTAGGGTAGGCAGGTT-1	Pericytes
TTAGGGTAGGTCATAA-1	Pericytes
TTAGGGTCAAATCCCA-1	Neural
TTAGGGTCACCGCTAG-1	Fibroblasts
TTAGGGTGTGATACAA-1	Pericytes
TTAGTCTTCAAACGAA-1	Epithelial
TTAGTCTTCCTGCTAC-1	Epithelial
TTAGTCTTCGCGCTGA-1	Fibroblasts
TTAGTCTTCTCATGCC-1	Muscle
TTATTGCCAAGCGCTC-1	Neural
TTATTGCGTCAGGAGT-1	Neural
TTATTGCTCGAAGGAC-1	Epithelial
TTCAATCAGACCAAGC-1	Myofibroblast_Mesothelium
TTCAATCAGCCGCACT-1	Epithelial
TTCAATCAGCTCATAC-1	Immune
TTCAATCAGTCACTCA-1	Muscle
TTCAATCAGTTGTAAG-1	Myofibroblast_Mesothelium
TTCAATCCATCCCGTT-1	Epithelial
TTCACCGAGGTGATAT-1	Fibroblasts
TTCACCGAGTAATACG-1	Myofibroblast_Mesothelium
TTCACCGAGTGAGCCA-1	Myofibroblast_Mesothelium
TTCACCGCAGTGGTGA-1	Epithelial
TTCACCGTCCGAACGC-1	Epithelial
TTCACCGTCTGGAAGG-1	Fibroblasts
TTCACGCAGATGCTTC-1	Fibroblasts
TTCACGCAGGAAACGA-1	Fibroblasts
TTCACGCCACAGCATT-1	Fibroblasts
TTCACGCGTACCTATG-1	Endothelial
TTCACGCTCACGTAGT-1	Epithelial
TTCACGCTCAGACCGC-1	Endothelial
TTCAGGAAGCCGGAAT-1	Fibroblasts
TTCAGGAAGGGATGTC-1	Epithelial
TTCAGGACACCGGCTA-1	Pericytes
TTCAGGACATGTGTCA-1	Neural
TTCAGGAGTCCTTGTC-1	Myofibroblast_Mesothelium
TTCAGGATCCGACGGT-1	Neural
TTCAGGATCGCTACAA-1	Epithelial
TTCATGTAGCCGTAAG-1	Endothelial
TTCATGTGTACCTAAC-1	Epithelial
TTCATGTGTAGCTAAA-1	Endothelial
TTCATGTGTCTCTCAC-1	Epithelial
TTCATTGAGATACCAA-1	Fibroblasts
TTCATTGAGCGTCTGC-1	Fibroblasts
TTCATTGCAACGTAAA-1	Fibroblasts
TTCATTGCAATCTGCA-1	Neural
TTCATTGCACAATTCG-1	Immune
TTCCAATCAATCCTTT-1	Neural
TTCCAATCACTTCAGA-1	Fibroblasts
TTCCAATCATGGCTAT-1	Endothelial
TTCCAATGTTAGCTAC-1	Neural
TTCCACGAGCAGCGAT-1	Muscle
TTCCACGCACAGAGCA-1	Fibroblasts
TTCCACGCACTAACGT-1	Fibroblasts
TTCCACGCAGGTGACA-1	Epithelial
TTCCGGTAGTCACTCA-1	Epithelial
TTCCGGTTCGTGAGAG-1	Myofibroblast_Mesothelium
TTCCGTGAGTCTGGAG-1	Endothelial
TTCCGTGCAAACTAAG-1	Endothelial
TTCCGTGCAGACACCC-1	Epithelial
TTCCGTGCAGCGCTTG-1	Fibroblasts
TTCCGTGGTTAATGAG-1	Epithelial
TTCCGTGTCACTGGTA-1	Endothelial
TTCCTAACAACGATTC-1	Myofibroblast_Mesothelium
TTCCTCTAGATAACAC-1	Epithelial
TTCCTCTAGCGTTCAT-1	Endothelial
TTCCTCTGTACTGGGA-1	Fibroblasts
TTCCTCTTCTCATTGT-1	Myofibroblast_Mesothelium
TTCCTCTTCTTCGCTG-1	Epithelial
TTCCTTCAGAAGCGCT-1	Myofibroblast_Mesothelium
TTCCTTCAGCCTCAGC-1	Fibroblasts
TTCCTTCAGCTGGCTC-1	Fibroblasts
TTCCTTCTCACGATCA-1	Epithelial
TTCCTTCTCTCGTCAC-1	Fibroblasts
TTCGATTAGGGACTGT-1	Myofibroblast_Mesothelium
TTCGATTCAAGGTTGG-1	Epithelial
TTCGATTGTCTGTAGT-1	Myofibroblast_Mesothelium
TTCGATTGTGGGATTG-1	Fibroblasts
TTCGATTTCCTCACCA-1	Epithelial
TTCGATTTCGCGTAGC-1	Fibroblasts
TTCGATTTCGTGCACG-1	Myofibroblast_Mesothelium
TTCGCTGAGAGATTCA-1	Epithelial
TTCGCTGAGTAGTGCG-1	Muscle
TTCGCTGCACGGCACT-1	Epithelial
TTCGCTGGTAGAGGAA-1	Fibroblasts
TTCGCTGTCAAAGGAT-1	Fibroblasts
TTCGCTGTCCGTAGGC-1	Myofibroblast_Mesothelium
TTCGCTGTCTTACTGT-1	Epithelial
TTCGGTCAGCGCCCAT-1	Pericytes
TTCGGTCCAGCGCTTG-1	Pericytes
TTCGGTCCATCCGAAT-1	Fibroblasts
TTCGGTCCATTCATCT-1	Fibroblasts
TTCTAGTAGCGTGAAC-1	Neural
TTCTAGTAGCGTTGTT-1	Fibroblasts
TTCTAGTCACTCACTC-1	Myofibroblast_Mesothelium
TTCTAGTGTGATAGAT-1	Epithelial
TTCTAGTTCCAGGACC-1	Epithelial
TTCTAGTTCGAGGCAA-1	Neural
TTCTCTCAGCTACAAA-1	Endothelial
TTCTCTCAGGGTGGGA-1	Epithelial
TTCTCTCCAACAAGTA-1	Epithelial
TTCTCTCCAACTGATC-1	Endothelial
TTCTCTCCAATTGTGC-1	Neural
TTCTCTCTCCAGCTCT-1	Fibroblasts
TTCTCTCTCTATCGGA-1	Fibroblasts
TTCTCTCTCTCAGAAC-1	Fibroblasts
TTCTCTCTCTCTGAGA-1	Fibroblasts
TTCTGTAAGTAGACCG-1	Pericytes
TTCTGTACACATGAAA-1	Fibroblasts
TTCTGTACATGGCTAT-1	Neural
TTCTGTAGTCAACCAT-1	Endothelial
TTCTGTATCAAAGCCT-1	Pericytes
TTCTGTATCGAGTCCG-1	Myofibroblast_Mesothelium
TTCTGTATCTGCCCTA-1	Myofibroblast_Mesothelium
TTCTTCCAGACGGTCA-1	Fibroblasts
TTCTTCCAGCGTCAAG-1	Epithelial
TTCTTCCGTCTACTGA-1	Pericytes
TTCTTCCTCTCATGGA-1	Myofibroblast_Mesothelium
TTCTTGAAGTCTGTAC-1	Myofibroblast_Mesothelium
TTCTTGACAAGCGAGT-1	Fibroblasts
TTCTTGAGTAAGATAC-1	Epithelial
TTCTTGATCGCTAAAC-1	Myofibroblast_Mesothelium
TTGAACGAGCCAGAGT-1	Fibroblasts
TTGAACGAGCTCATAC-1	Endothelial
TTGAACGAGTACCATC-1	Epithelial
TTGAACGCAAGCTGCC-1	Muscle
TTGAACGCAAGGCCTC-1	Epithelial
TTGAACGCAGCATCTA-1	Fibroblasts
TTGAACGCAGGTAGTG-1	Endothelial
TTGAACGCATGCCGGT-1	Fibroblasts
TTGAACGGTCCTTAAG-1	Fibroblasts
TTGAACGGTTCTTAGG-1	Myofibroblast_Mesothelium
TTGAACGTCTCAGGCG-1	Endothelial
TTGAACGTCTGAGGTT-1	Fibroblasts
TTGACCCAGGATATGT-1	Epithelial
TTGACCCAGGTCCTGC-1	Myofibroblast_Mesothelium
TTGACCCAGTATGGCG-1	Pericytes
TTGACCCAGTTTGTCG-1	Epithelial
TTGACCCCAAAGGGTC-1	Neural
TTGACCCCATTGCCGG-1	Epithelial
TTGACCCGTCCTCATC-1	Pericytes
TTGACCCGTTCCGCGA-1	Fibroblasts
TTGACCCTCCACAGGC-1	Endothelial
TTGACCCTCTGTTGGA-1	Pericytes
TTGAGTGAGGAAAGTG-1	Myofibroblast_Mesothelium
TTGAGTGAGGTGCCAA-1	Fibroblasts
TTGAGTGAGGTGCTAG-1	Fibroblasts
TTGAGTGGTATTCCGA-1	Fibroblasts
TTGAGTGGTCGCATCG-1	Endothelial
TTGAGTGGTGGATACG-1	Myofibroblast_Mesothelium
TTGAGTGTCACAGAGG-1	Endothelial
TTGAGTGTCTGTACAG-1	Muscle
TTGATGGGTGACCTGC-1	Fibroblasts
TTGCATTAGACGGATC-1	Epithelial
TTGCATTCAGAGGCTA-1	Pericytes
TTGCATTCAGGACGAT-1	Endothelial
TTGCCTGCACCCTAGG-1	Epithelial
TTGCCTGCACGGTAGA-1	Epithelial
TTGCCTGGTGGATCGA-1	Pericytes
TTGCCTGTCTGGGCCA-1	Fibroblasts
TTGCGTCAGGGACCAT-1	Fibroblasts
TTGCGTCCACCACTGG-1	Fibroblasts
TTGCGTCGTCCTTAAG-1	Epithelial
TTGCGTCTCAACGAGG-1	Epithelial
TTGCTGCAGCAATTCC-1	Fibroblasts
TTGCTGCAGGGAGATA-1	Endothelial
TTGCTGCCAAAGGTTA-1	Fibroblasts
TTGCTGCCACTGTCCT-1	Fibroblasts
TTGCTGCGTCGAGTTT-1	Myofibroblast_Mesothelium
TTGCTGCGTGCCTACG-1	Myofibroblast_Mesothelium
TTGCTGCGTGTCGCTG-1	Fibroblasts
TTGCTGCGTTGAGTCT-1	Fibroblasts
TTGCTGCTCAGGTAAA-1	Epithelial
TTGCTGCTCCAGCTCT-1	Myofibroblast_Mesothelium
TTGCTGCTCCCTCGTA-1	Endothelial
TTGCTGCTCGCCACTT-1	Endothelial
TTGGATGAGCCTGACC-1	Fibroblasts
TTGGATGGTCCATACA-1	Pericytes
TTGGATGTCGACGACC-1	Pericytes
TTGGGATAGTAGGGTC-1	Neural
TTGGGATAGTTGCATC-1	Pericytes
TTGGGATCAATGCAGG-1	Myofibroblast_Mesothelium
TTGGGATCACGGCCAT-1	Fibroblasts
TTGGGCGAGACTTCAC-1	Fibroblasts
TTGGGCGAGGCCTAGA-1	Fibroblasts
TTGGGCGAGTGTGTTC-1	Myofibroblast_Mesothelium
TTGGGCGCACGACGAA-1	Fibroblasts
TTGGGCGGTACCATAC-1	Fibroblasts
TTGGGCGTCTAGTTCT-1	Pericytes
TTGGGTATCATTGGTG-1	Epithelial
TTGGGTATCTAGTTCT-1	Fibroblasts
TTGGTTTAGCTTACGT-1	Myofibroblast_Mesothelium
TTGGTTTAGGACGCAT-1	Myofibroblast_Mesothelium
TTGGTTTCAGAAATCA-1	Fibroblasts
TTGGTTTCAGCCCAGT-1	Pericytes
TTGGTTTGTTCGTACA-1	Epithelial
TTGGTTTTCAAGATAG-1	Epithelial
TTGGTTTTCCTCATAT-1	Neural
TTGTGGACACATTCGA-1	Fibroblasts
TTGTGGACATCGATAC-1	Endothelial
TTGTGGAGTAGGCAAC-1	Fibroblasts
TTGTGGAGTGGCACTC-1	Epithelial
TTGTGTTAGAACTTCC-1	Myofibroblast_Mesothelium
TTGTGTTAGTGGTTGG-1	Epithelial
TTGTGTTCACATATGC-1	Fibroblasts
TTGTGTTCATGAATCC-1	Epithelial
TTGTGTTTCCAGCCTT-1	Myofibroblast_Mesothelium
TTGTGTTTCGATTTCT-1	Fibroblasts
TTGTGTTTCGGATACT-1	Fibroblasts
TTGTTCAAGCGCTGAA-1	Fibroblasts
TTGTTCAAGCTCGAAG-1	Epithelial
TTGTTCAAGGAAAGGT-1	Immune
TTGTTCACACCCTTGT-1	Myofibroblast_Mesothelium
TTGTTCACATGTACGT-1	Myofibroblast_Mesothelium
TTGTTCAGTATCGCAT-1	Epithelial
TTGTTCAGTGCCGAAA-1	Epithelial
TTGTTCAGTTTACCTT-1	Epithelial
TTGTTCATCCGGCTTT-1	Pericytes
TTGTTCATCTCGACGG-1	Myofibroblast_Mesothelium
TTGTTGTAGCTAATCC-1	Myofibroblast_Mesothelium
TTGTTGTAGTTCGCAT-1	Neural
TTGTTGTCAGAGAAAG-1	Fibroblasts
TTGTTGTGTCGTCAGC-1	Fibroblasts
TTGTTTGAGGGAGGGT-1	Endothelial
TTGTTTGAGTGGTGAC-1	Epithelial
TTGTTTGCAGGCTACC-1	Epithelial
TTGTTTGTCACTTATC-1	Endothelial
TTGTTTGTCCATGCAA-1	Fibroblasts
TTTACCAAGGATCATA-1	Epithelial
TTTACCATCATCGCCT-1	Endothelial
TTTACCATCCCTCATG-1	Epithelial
TTTACGTCACACCTTC-1	Myofibroblast_Mesothelium
TTTACGTGTAACATAG-1	Fibroblasts
TTTACGTTCAAAGCCT-1	Endothelial
TTTACTGCAAAGGAGA-1	Epithelial
TTTACTGGTAGAGACC-1	Epithelial
TTTACTGGTCTCCCTA-1	Epithelial
TTTACTGTCAGACCTA-1	Pericytes
TTTACTGTCGCCCAGA-1	Epithelial
TTTAGTCAGCGGTAAC-1	Epithelial
TTTAGTCAGTAAAGCT-1	Epithelial
TTTAGTCCAAATTGCC-1	Immune
TTTAGTCCACTTCCTG-1	Fibroblasts
TTTATGCCAGCAATTC-1	Epithelial
TTTATGCCAGGTTCCG-1	Pericytes
TTTATGCCATCCGCGA-1	Epithelial
TTTATGCTCGCTGACG-1	Myofibroblast_Mesothelium
TTTATGCTCGGCCTTT-1	Fibroblasts
TTTATGCTCGTCAAAC-1	Epithelial
TTTCACACAACTGTGT-1	Pericytes
TTTCACACAATTGCGT-1	Epithelial
TTTCACAGTCACTACA-1	Fibroblasts
TTTCACAGTTTAGTCG-1	Fibroblasts
TTTCACATCGACATTG-1	Fibroblasts
TTTCATGGTTTACCTT-1	Neural
TTTCCTCCAGCACCCA-1	Epithelial
TTTCCTCCAGGAATCG-1	Fibroblasts
TTTCCTCGTTCGGTTA-1	Fibroblasts
TTTCCTCTCCCATTTA-1	Myofibroblast_Mesothelium
TTTCGATAGCACGTCC-1	Fibroblasts
TTTCGATAGCAGGTCA-1	Immune
TTTCGATCAAATCGTC-1	Pericytes
TTTCGATCATGGTACT-1	Epithelial
TTTCGATGTCTACATG-1	Fibroblasts
TTTCGATGTGGTCCCA-1	Fibroblasts
TTTGACTCAAAGACTA-1	Fibroblasts
TTTGACTCATAATCCG-1	Neural
TTTGACTGTAGGATAT-1	Fibroblasts
TTTGACTGTCAGTCCG-1	Endothelial
TTTGACTTCAGACTGT-1	Epithelial
TTTGATCAGACGCCCT-1	Neural
TTTGATCAGGCCCACT-1	Fibroblasts
TTTGGAGAGCGATGCA-1	Epithelial
TTTGGAGAGCTACGTT-1	Fibroblasts
TTTGGAGGTTCAACGT-1	Endothelial
TTTGGAGTCATTGTTC-1	Neural
TTTGGAGTCTATTCGT-1	Epithelial
TTTGGAGTCTCGTTTA-1	Epithelial
TTTGGTTAGAGCAGAA-1	Fibroblasts
TTTGGTTCAACTCCCT-1	Fibroblasts
TTTGGTTCAAGTACCT-1	Muscle
TTTGGTTCATGGCACC-1	Fibroblasts
TTTGGTTGTAGGTAGC-1	Fibroblasts
TTTGGTTGTGACCGTC-1	Endothelial
TTTGGTTTCCTGCTAC-1	Neural
TTTGTTGAGAAGCTGC-1	Muscle
TTTGTTGCAGTGACCC-1	Epithelial
TTTGTTGTCCGCTTAC-1	Epithelial
