GGATTCCGCTATACCC-1	Endothelium
ATGCCGGTTGATGGGA-1	Muscle
TGAGCTTTAATGACGC-1	Muscle
TCCCTTAGATTACTCG-1	Endothelium
ATATCTCCCTCGTTAA-1	Muscle
AGCTCTTCCCAGTGCA-1	Muscle
TCGCTAAACCGCTATC-1	Muscle
CACATTCTTTCGATGG-1	Muscle
GATATGCGGTAGCCAA-1	Muscle
CCAATTACGGGTCGAG-1	Muscle
GTCGTATTGGCGTACA-1	Muscle
TTCTTGGAGTAATGAG-1	Endothelium
GTCTCGATCTGCTTTC-1	Muscle
TACTCTCCGAACAAAT-1	Muscle
ATCACATTAGAATATC-1	Neural
TACGGGATGCTAGCAG-1	Muscle
AGCTGAAGTAAACCAA-1	Neural
CATGGGTCGGGTGTGG-1	Muscle
CACCCACGAGGCAATT-1	Muscle
TGCCATTACTAAAGAA-1	Muscle
CCGTTACGTTAGAACA-1	Muscle
GCCAGGAGTAACCGAT-1	Muscle
GGAAAGTGCCCATGCC-1	Neural
TCTTACCGGAACTCGT-1	Muscle
TATGTCAAGACCGACT-1	Neural
CCTAACTAAGGCTCTA-1	Muscle
GCGGTGAACTGCGCTC-1	Muscle
CCTCGCGCGATATAGG-1	Muscle
ATCGGCAAGCAGTCCA-1	Muscle
AGATCGTGCATAAGAT-1	Neural
AGCTAGAAGCAGAAGT-1	Muscle
CAGCCTCCTGCAGAGG-1	Muscle
CTTAGCCTTCCACATG-1	Neural
ATTAATGAACCAGTCG-1	Muscle
ACGATACATAGAACTA-1	Muscle
AGCCACTCCCGTGCTT-1	Muscle
ATACGGGTTTCGATTG-1	Muscle
CTGTCAAATGGCTCGG-1	Fibroblasts
GCTCGGAATTTAAAGC-1	Fibroblasts
TAGGCATGTTACGCCA-1	Fibroblasts
TGGCAACTCGCGCGCC-1	Fibroblasts
ATCAGTAGGCAGGGAT-1	Fibroblasts
TATCGATCTATGCATA-1	Fibroblasts
CGACTCAGGATGTTAT-1	Fibroblasts
GCCATATTGCACACAG-1	Fibroblasts
AATTCATAAGGGATCT-1	Fibroblasts
CGGTAGAGGTGCAGGT-1	Fibroblasts
AATGATGATACGCTAT-1	Pericytes
CTTGTGCTCACCGATT-1	Neural
TTCCAATCAGAGCTAG-1	Fibroblasts
CGATGGACCCTACGCC-1	Muscle
GGTCGGATAAACGGCG-1	Fibroblasts
TTAGCTAATACGATCT-1	Neural
CTCGATATTTGCGAGC-1	Muscle
ATTACTTACTGGGCAT-1	Neural
CTAGCCGATGTTATGA-1	Muscle
TACTGCAATCAATTAC-1	Muscle
TAGTCTGTGACGTTGC-1	Neural
ATAACGGAGTCCAACG-1	Muscle
AACGATATGTCAACTG-1	Muscle
GACAACGACCATTGAA-1	Muscle
TTGACCATGTTCTCCG-1	Muscle
AGTACGGGCACCTGGC-1	Fibroblasts
CGCCATCCGATTATGA-1	Fibroblasts
AAGGTATCCTAATATA-1	Fibroblasts
TGTTGTCAAGAAGTCT-1	Fibroblasts
CAGTGAATAAATGACT-1	Epithelial
CACCTTGCGAAACTCG-1	Muscle
CATTTAGCGGACCATG-1	Epithelial
CCAGTCTAGACGGCGC-1	Myofibroblast_Mesothelium
TCGCTTTAAACGTTTG-1	Epithelial
GTGAAACGGCGCCACC-1	Epithelial
GGGCTCATCGAACCCA-1	Epithelial
TTGATGTGTAGTCCCG-1	Epithelial
CAGTAGCCCACGCGGT-1	Epithelial
AGCGCGGGTGCCAATG-1	Muscle
TAATCGATCCGTACGT-1	Epithelial
AGTGGCGGCAATTTGA-1	Fibroblasts
CCTTTCAATGAAGAAA-1	Muscle
CTCAGTCACGACAAAT-1	Endothelium
ATAGGCTAGCTTCGCA-1	Fibroblasts
CGGTTCAAGTAGGTGT-1	Fibroblasts
CAGTCGAGGATGCAAT-1	Immune
TATCACCCAACCGACC-1	Fibroblasts
AATGATGCGACTCCTG-1	Fibroblasts
TGGAACCACTGACACA-1	Muscle
GCCAATAGGGCATCTC-1	Muscle
TTCTTTGGTCGCGACG-1	Neural
ATTAGATTCCTCAGCA-1	Neural
CCGTGGAACGATCCAA-1	Muscle
GGGTCGTGGCAAGTGT-1	Muscle
CAATAAACCTTGGCCC-1	Muscle
ACTTCGCCATACGCAC-1	Neural
ATCTGGTTAAGACTGT-1	Muscle
TCGTAAGACGACATTG-1	Muscle
GTGTACCTTGGCTACG-1	Fibroblasts
GCCCGTAATACCTTCT-1	Fibroblasts
CGGTCAAGTGGGAACC-1	Fibroblasts
TTGTAAGGCCAGTTGG-1	Myofibroblast_Mesothelium
GGAGCACCAAGAACTA-1	Epithelial
TAATAGTGACGACCAG-1	Epithelial
CTAAATCCTATTCCGG-1	Epithelial
CGAGTTCTGTCCCACC-1	Epithelial
AGGCAGATGCGTAAAC-1	Epithelial
AAGGATGAGGGACCTC-1	Epithelial
AGAGAACCGTCTAGGA-1	Epithelial
GAGGGCGCAGCTCTGC-1	Epithelial
AAGATTGGCGGAACGT-1	Epithelial
CCAGTAGTCTGATCCA-1	Epithelial
AAGGGACAGATTCTGT-1	Epithelial
ATAGAGTTATCAACTT-1	Epithelial
AAATTACCTATCGATG-1	Epithelial
GATCCTAAATCGGGAC-1	Epithelial
TTACAGACCTAAATGA-1	Epithelial
CCTCACCTTAGCATCG-1	Epithelial
CATGCGACCAGTTTAA-1	Muscle
AACATATCAACTGGTG-1	Epithelial
CTATAAGAGCCAATCG-1	Fibroblasts
AATATCGAGGGTTCTC-1	Fibroblasts
GTACTCCTGGGTATGC-1	Fibroblasts
ATAAGTAGGATTCAGA-1	Fibroblasts
AGGTCGCGGAGTTACT-1	Muscle
CTAATTCTCAGATATT-1	Muscle
GCCAACCATTTCCGGA-1	Neural
TGATCCCAGCATTAGT-1	Neural
CGTTGTAAGATTGATT-1	Fibroblasts
CGAGAGATGTGAACCT-1	Endothelium
TCGCTGGGCGGATTGT-1	Pericytes
AGATCTCAGGTGTGAT-1	Neural
TGGCCAAACTGAAGTA-1	Muscle
GCTTCCGTCCCTAGAC-1	Muscle
CAGCAGCCCGTTCCTT-1	Fibroblasts
TGTATAACAGATCCTG-1	Fibroblasts
CGCGGGAATTAGGCAG-1	Fibroblasts
TGCATGTGGTAATCTA-1	Epithelial
ACAATTTGAGCAGTGG-1	Epithelial
GAGCTAAGGGCATATC-1	Epithelial
CCAGATAGTTGAGTGA-1	Epithelial
CCACAATGTACGTCTT-1	Epithelial
CAATGGATCTCTACCA-1	Epithelial
TGTGGCAAAGCGTATG-1	Epithelial
TAAAGCGTTAGGAGAA-1	Epithelial
TCCGTTTAGCCTTGAA-1	Epithelial
CAGCTCGACAAGTTAA-1	Epithelial
GCCTATAGTGTCAGGG-1	Epithelial
ATAGACAACGGGACCT-1	Epithelial
CTACTATCTTTCAGAG-1	Epithelial
GCGCTGCTTTGCATTT-1	Epithelial
GCGCATCCAGTCAGCA-1	Epithelial
GACTCGCGGGAATGAC-1	Epithelial
CTGGTAACGAGCTCTT-1	Epithelial
TCCGGCCTAGCGTACA-1	Epithelial
TCTAGGTGGCGACGCT-1	Epithelial
ACGCTAGTGATACACT-1	Epithelial
ATCTGCACCTCTGCGA-1	Epithelial
CCTCACCTGAGGGAGC-1	Muscle
AGTGAGCCTCGCCGCC-1	Myofibroblast_Mesothelium
ACGAGTACGGATGCCC-1	Fibroblasts
GGTACCATTAAGACGG-1	Fibroblasts
TTCTGCTAGACTCCAA-1	Muscle
TAACTATTACGCCAAA-1	Muscle
GCATTCAAGGCAACGC-1	Neural
AGTACATCATTTATCA-1	Muscle
GTCGTGTCTGGTCATC-1	Fibroblasts
AGTCTAAAGTATACTC-1	Muscle
TCAGCAAATGCATCTC-1	Muscle
GAGATCTGTCACTCCG-1	Neural
ATGCCGGTCTTGCATA-1	Muscle
TTGGGCGGCGGTTGCC-1	Muscle
TTGTTGTGTGTCAAGA-1	Fibroblasts
ACTGTACGATACACAT-1	Fibroblasts
TCCACTTTATCTAGGT-1	Muscle
GGTCTGAGAATCTGGA-1	Myofibroblast_Mesothelium
TAGAAAGGTGGCGCTA-1	Epithelial
TATGTCTCATTGTGCC-1	Epithelial
GGATTTCACTTCTATA-1	Epithelial
TGAGTGGTCCGTGACG-1	Epithelial
CGCTTTCTTGCATTCG-1	Epithelial
ACCCAACGCCCGTGGC-1	Epithelial
GAACGTCTCATGGTCG-1	Epithelial
AGGGTTCCCTTTGGTT-1	Epithelial
GTAGCTTCCTCTTGTT-1	Epithelial
GCATGAGGGACGCGGC-1	Epithelial
CTACCCTAAGGTCATA-1	Epithelial
TCACCGCTCGGCACTC-1	Epithelial
GGCTCGCGTTGAGGTA-1	Epithelial
CTAACGAAACTTGCTG-1	Epithelial
TTAAACTCGAATTCAT-1	Epithelial
TACTTTACTGAGCCGG-1	Epithelial
GCTTGGATCGATTAGG-1	Epithelial
CGGTTATCCAACAGTG-1	Epithelial
CAGACCTGTAAGTGTT-1	Epithelial
GACGGTCAATAGAAGC-1	Epithelial
CTGACTGCGCAGCTCG-1	Epithelial
CCATACCTTTACTTGT-1	Epithelial
GTAATAAAGGGCTCCC-1	Epithelial
GTGAACTCCCATTCGA-1	Epithelial
GTGGTTACTTCTTTCG-1	Epithelial
TCAGAACCTCCACAGG-1	Fibroblasts
TCCCACTCTCTTCCGG-1	Fibroblasts
ATCTTGACTTGTCCAA-1	Muscle
TCGGGAACGTGCCTAG-1	Muscle
GTTAGCCGTAAATCAA-1	Neural
ATTTACTAAGTCCATT-1	Muscle
GGGTGCATATGAAAGC-1	Neural
TCGGAGTACATGAGTA-1	Muscle
GGGAGTTAATGAGGCG-1	Neural
CCGGGCGGTCTCGTCA-1	Muscle
CCGTAAGTTGGTCCCA-1	Muscle
GGAGGGCTTGGTTGGC-1	Fibroblasts
TCGGACGCCCAGCCCA-1	Fibroblasts
TCTGTGCCATCATAGT-1	Epithelial
GTACTGGAGTTAGACC-1	Epithelial
GGAATGCGCTAGCGTG-1	Epithelial
GTGTGAATAACTTAGG-1	Epithelial
GGTCGGCCAGGAGCTT-1	Epithelial
TAGCCGGCGGTCAGCG-1	Epithelial
CGGGTGTACCCATTTA-1	Epithelial
AGTGATTCAAGCAGGA-1	Epithelial
GTTGGATTGAGAACAC-1	Epithelial
CACACGCGCTGTCTTA-1	Epithelial
TAGACGCCCGTACCGG-1	Epithelial
GGTTTCAATCGGTCAG-1	Epithelial
AATCTGCGTTGGGACG-1	Epithelial
TTACGGATGGTTCGAG-1	Epithelial
CGGCAGGGTCGGGTTG-1	Epithelial
GCTTTCAGAGGAGGTG-1	Epithelial
TCTTCCCATGGGCACA-1	Epithelial
TACCGCGGACTTGCAG-1	Epithelial
AGAATTATGGATTCGA-1	Epithelial
ATTGATGAGTCCTAAC-1	Epithelial
TAGGTCGCCGGAACTG-1	Epithelial
TAACCTACCGTCCGAG-1	Epithelial
CTTAGTAGGCCTACAG-1	Epithelial
CTAGATGTGAGTGTAA-1	Epithelial
ACTCCCGAATTCGTTT-1	Epithelial
GTTCATCGTTTGGCTG-1	Epithelial
ACTTTACCCTCATGAA-1	Epithelial
GCGAGAGTTGCGTCCA-1	Epithelial
GTTCGGGCGTACCATT-1	Fibroblasts
CGACTTTGTATAGCCT-1	Muscle
TTGAATATGGACTTTC-1	Neural
AAGAGCTCTTTATCGG-1	Muscle
TTACTCCGGCCGGGAA-1	Muscle
AAACGAGACGGTTGAT-1	Fibroblasts
GCTAAGTAGTTTCTCT-1	Fibroblasts
ATAACGCCGGAGGGTC-1	Fibroblasts
GGATCCGGAATATACT-1	Epithelial
TGAAAGGACCTGACTC-1	Myofibroblast_Mesothelium
TCCGCGGCAGCATCTG-1	Epithelial
TGCATATGTCTGTCAC-1	Epithelial
TGTAGGAGAAATTTCC-1	Epithelial
AGTGAGACTTCCAGTA-1	Epithelial
CCCAAACATGCTGCTC-1	Epithelial
GCTTATGAAGCAGGAA-1	Epithelial
TTCTAACCGAAGCTTA-1	Epithelial
GGATGTCCTTACCGCA-1	Epithelial
AGGGTGCTCTCGAGGG-1	Epithelial
AACTCTCAATAGAGCG-1	Epithelial
TCTGAATTCCGTACAA-1	Epithelial
GCGTGGTACTGGGTTA-1	Epithelial
CGTCGGATAGTGTTGA-1	Epithelial
ATATGTCTCCCTAGCC-1	Epithelial
TCTTTAAGACTATGAA-1	Epithelial
TCATTTAAGTCTCCGA-1	Epithelial
GATATTGAGATTGGCG-1	Epithelial
TGACATCGAGCGGACC-1	Epithelial
GCGTAAATGGCCATAA-1	Epithelial
ATTGTACAACTCGGCT-1	Epithelial
TACGCTATAGAAACCT-1	Epithelial
CACCCAAATCTTATGT-1	Epithelial
AGATGATGGAGTCTGG-1	Epithelial
CCACGGTGCCCGGTAG-1	Epithelial
TCAAGAAATACTAGCT-1	Epithelial
AGGTATAATTGATAGT-1	Epithelial
CAAGGTCCTATAGGCT-1	Fibroblasts
CCGGCACGACCGTTTC-1	Fibroblasts
GCGATTGTTAACGTTA-1	Muscle
ACTCGTCAGTAATCCC-1	Muscle
GGTGATAAGGAGCAGT-1	Neural
AAGAGGCATGGATCGC-1	Fibroblasts
CACGTTCGTGCTCTAG-1	Fibroblasts
CTATTTGGTTACGGAT-1	Fibroblasts
GTACAGAGGCAAGGGT-1	Muscle
GGGCCGGCCGAAGTAC-1	Myofibroblast_Mesothelium
CCTGAACGATATATTC-1	Epithelial
CCGGGCTGCTCCATAC-1	Epithelial
TACTTGTTAGTAGTCC-1	Epithelial
CCTAGGCGTAGCGATC-1	Epithelial
CTGGCGCACAGGTCTG-1	Epithelial
ACTTATACTTACCCGG-1	Epithelial
GAAGTCTCCCTAGCGA-1	Epithelial
ACCGATGGTAGCATCG-1	Epithelial
CGAGTTTATCGGACTG-1	Epithelial
CATAACGGACAGTCGT-1	Epithelial
TGACGATGCACTAGAA-1	Epithelial
TAGGGAGCTTGGGATG-1	Epithelial
AGGGTCGATGCGAACT-1	Epithelial
TATATCCCTGGGAGGA-1	Epithelial
CATCTTACACCACCTC-1	Epithelial
GTGCGACAGGGAGTGT-1	Epithelial
CCGATCTCAACCTTAT-1	Epithelial
ACGATCATCTTGTAAA-1	Epithelial
GAAAGAACAGCGTTAT-1	Epithelial
CTAGGTCTGAAGGAAT-1	Epithelial
ATATCAACCTACAGAG-1	Epithelial
AAATAGCTTAGACTTT-1	Epithelial
GCGACATGTAAACATC-1	Epithelial
ATAAGTAGGGCGACTC-1	Epithelial
GCGAGCGCATGCTCCC-1	Epithelial
AGGGACCGGCTGCGTT-1	Epithelial
CCTATGAAGTGGTGCC-1	Myofibroblast_Mesothelium
GCTTACGTAGTTAGTA-1	Endothelium
CATACTTAGGCAATAC-1	Fibroblasts
CGAGGGACTGCGGTCG-1	Muscle
AATCGCCTCAGCGCCA-1	Muscle
CTTGTTGCTGAGTCAA-1	Muscle
GATATGAGACACTAAC-1	Muscle
TTATGATCTTAACGAA-1	Fibroblasts
CGCCGCCCATGCCTGT-1	Fibroblasts
CTGGGATAAATAATGG-1	Epithelial
GTGCCCGTTCGGATTC-1	Epithelial
TTCAATACTCTGAATC-1	Epithelial
CGCACATGTCCACTAC-1	Epithelial
AGAAGAGCGCCGTTCC-1	Epithelial
GATAACTCGCACTGTG-1	Epithelial
AGTCGACGGTCTCAAG-1	Epithelial
GTGACCGCACACTACG-1	Epithelial
GTATGTGGGTCTAGTT-1	Endothelium
CTTGAGTTAGGGTAAT-1	Epithelial
TTAGCTGATTTGCCGT-1	Epithelial
GCTGTTGCTACCGAAC-1	Epithelial
TATTACCATCCTGCTT-1	Epithelial
TTGAATTCACGTGAGG-1	Epithelial
CCATCTCACCAGTGAA-1	Epithelial
CGCACGTGCGCTATCA-1	Epithelial
ACCCGGATGACGCATC-1	Epithelial
CGCTAGAGACCGCTGC-1	Epithelial
ATAGTTCCACCCACTC-1	Epithelial
GCAGACCCAGCACGTA-1	Epithelial
TAGACTACCTAGCGTT-1	Epithelial
GGTTCTACTCGTCTGA-1	Epithelial
GACTCACCCACGTGAG-1	Epithelial
AGCTCTTCGTAACCTT-1	Epithelial
ACTATCCAGGGCATGG-1	Epithelial
AAGGATCGATCGCTTG-1	Epithelial
ATATCGGTAGGGAGAT-1	Epithelial
TTCCAGACGAGATTTA-1	Epithelial
GACCGACGTGAAAGCA-1	Epithelial
CCTGGAAACGTTCTGC-1	Muscle
CCGGTAATGGCTAGTC-1	Fibroblasts
TTCTGCGGGTTAGCGG-1	Neural
CTCGGTACCACTGCTC-1	Neural
GTAAGTAACAGTCTGG-1	Muscle
GTGCGTGTATATGAGC-1	Muscle
ATTTGTCTTGGGAGCT-1	Muscle
CCTCGGACCGGGATAG-1	Epithelial
TAGGTGCTCGCCTAGC-1	Epithelial
CTTTAGGAACACTGTT-1	Epithelial
TCGGGCCGTCGTGGTA-1	Epithelial
AGTGCTTGCACGAATA-1	Epithelial
TGCAGTTTCCTCCCAT-1	Epithelial
TGAGAGATTTACCACG-1	Epithelial
GAAACAGATGACCACC-1	Epithelial
AGCAACATATCTTATT-1	Epithelial
CAAGTGTGGTTGCAAA-1	Epithelial
GCCTCATCTGGAAATA-1	Epithelial
AACCCTACTGTCAATA-1	Epithelial
ACGTATTACTCCGATC-1	Epithelial
TCTGGGAACCTTTGAA-1	Epithelial
GCTCGCTCATGTCCAA-1	Epithelial
GCGCAAGAGCGCGCTG-1	Epithelial
TTGACGCTCCATGAGC-1	Epithelial
TATAGATGGTCGCAGT-1	Epithelial
TTACATGCCACAACTA-1	Epithelial
ACATGGCGCCAAAGTA-1	Epithelial
TATGGTTAGTGGGAGA-1	Epithelial
CATGACTTCGCTGAAT-1	Epithelial
ACCACCAATGTAACAA-1	Epithelial
TCTTAGAGCTCCAATT-1	Epithelial
CCACGAATTTAACCTC-1	Epithelial
TTCTTGCTAGCATCTC-1	Epithelial
ACACCTTACTACTTGC-1	Epithelial
AGTCGGTTGCGTGAGA-1	Myofibroblast_Mesothelium
ACCTACAGTATGTGGT-1	Immune
GAGGATAAACAGTGCT-1	Fibroblasts
TTCCGGTATCTGTGTC-1	Fibroblasts
CCCAGTTAAGGCGCCG-1	Neural
CGGTACTAGAATCAAA-1	Muscle
GCTTAATGTAACTAAC-1	Neural
AGGACAGTCGAATCCC-1	Fibroblasts
GACAGCCAGACCTGAC-1	Epithelial
GGCGAAATCTAACTTG-1	Muscle
CTGGTAACACATAGAA-1	Epithelial
TAGCCATTTCAAAGTC-1	Epithelial
GGGATTTACCGCACCT-1	Epithelial
ATGCCATTTGCGACCA-1	Epithelial
GAATAGACGCGACCCA-1	Epithelial
TGTATGGCGCAGACAG-1	Epithelial
GGATGAAGATCGCTGA-1	Epithelial
CGACAATTTGATCTAA-1	Epithelial
AAAGTTGACTCCCGTA-1	Epithelial
CGCGGCTCAACTTGAA-1	Epithelial
CACGCGGAACTGTTGC-1	Epithelial
TCTTAGAGTGAACTCT-1	Epithelial
AGTCCATTGGCTGATG-1	Epithelial
TTAAGATAGGATTGAC-1	Epithelial
ACATCCTGGTAACTGT-1	Epithelial
CACCTTGGCGCCTTTG-1	Epithelial
GCTAGACCGTCTACTG-1	Epithelial
CGGCCCAGGTATATCC-1	Epithelial
GTCCATTACTGCTACG-1	Epithelial
GGGTTTAGGATAGGAT-1	Epithelial
TAATTAGGACATCCGT-1	Epithelial
GCTCCCAGTCGGTCCA-1	Epithelial
ATTCGTGCTATCTCTT-1	Epithelial
GTTAACTATGTTGTCA-1	Epithelial
GCTCCGCTCGCTTCAG-1	Epithelial
GCAACGGCTAGTTATG-1	Epithelial
AATCGCGCAGAGGACT-1	Muscle
AGGTTACACCATGCCG-1	Epithelial
CGAGATTTCGCTCGGG-1	Fibroblasts
AATTGAACGCTCTGGT-1	Fibroblasts
ACAAATGGTAGTGTTT-1	Muscle
ATGGTCGCGTGGTTTC-1	Muscle
TGTTATTGTATGTGGC-1	Muscle
TTCCGGTTACCCACTT-1	Fibroblasts
GAGTGTGCGGTACCCA-1	Muscle
CAAGATATTATAACGT-1	Muscle
ACACACCAGGACCAGT-1	Epithelial
ATGGGCCTCGGCCTCT-1	Epithelial
AAGGTGATAAACCAGC-1	Epithelial
TCTTACTTATGCCTCT-1	Epithelial
AAAGTGTGATTTATCT-1	Epithelial
TGCTCCACAGTTCTTA-1	Epithelial
CTGGCTGATTCATCCT-1	Epithelial
TAAGGCTGAATCCCTC-1	Epithelial
TCTAGTGATATCGTGG-1	Epithelial
TCGAAGAACCGAGCAC-1	Epithelial
GACAAACATATGCAGG-1	Epithelial
AAGTCAATTGTCGTCA-1	Epithelial
AGTGAACAAACTTCTC-1	Epithelial
CATGATGGAAGTTAGC-1	Epithelial
AAGTGCCTTGACTGTA-1	Epithelial
ATCGCCAGTCAACATT-1	Epithelial
ACCGCGGTGGAAGTCG-1	Epithelial
TCTTCTATAACCCGCC-1	Epithelial
CACATTTCTTGTCAGA-1	Epithelial
TAGCGTCCCTCGATTG-1	Epithelial
GTTCGGATCGGGAACA-1	Epithelial
CAAACTCGCGACGCCG-1	Epithelial
GTCTTGTAGCTATTCA-1	Epithelial
TCTCGACGTATCGCCG-1	Epithelial
TTGCCAAGCAGAACCC-1	Epithelial
AAACCCGAACGAAATC-1	Fibroblasts
TTGAGCAGCCCACGGT-1	Neural
CGCCTTTAGCATGCTC-1	Epithelial
TCCTACATCCACGGCC-1	Pericytes
TTCAGCCCTGGTCCAC-1	Endothelium
TTAGAGTTTAGAAGGA-1	Neural
GGTTAGCTATATGTCT-1	Muscle
CTGGTTTCGAGCAAGA-1	Neural
TGGGCCCATACTAATT-1	Fibroblasts
ACTTATTTATGTGCCA-1	Muscle
TTAGTTATTCGTGGCA-1	Myofibroblast_Mesothelium
AACCGCTAAGGGATGC-1	Epithelial
ATACGTCCACTCCTGT-1	Epithelial
CGACACGCTCCGACAG-1	Epithelial
TCTGAACTCGTACCCG-1	Epithelial
AGGATATAGGGATTTA-1	Epithelial
GTGATCACTAACGCCT-1	Epithelial
ACCGGGCCTTTGTTGA-1	Epithelial
TTGACAGGAGCTCCCG-1	Epithelial
CTCTTCTATTGACTGG-1	Epithelial
CGTGGCCGAATATCTA-1	Epithelial
GGTTTAGCCTTTCTTG-1	Epithelial
TCAAGGTTACTACACC-1	Epithelial
TTGACTATTGTCCGGC-1	Epithelial
CGGGAATATAGTATAC-1	Epithelial
GCAACAGCAGTATGCG-1	Epithelial
ATCAAACACTGTTCCA-1	Epithelial
TGGGCAATAGTTGGGT-1	Epithelial
TGAATGTCAGCCGGCC-1	Epithelial
CGGCTCTAAAGCTGCA-1	Epithelial
GGACACAAGTTTACAC-1	Epithelial
CCGAGAAGTCGCATAA-1	Epithelial
AACTACCCGTTTGTCA-1	Epithelial
GCACAAACGAGGCGTG-1	Fibroblasts
CACACAGCTTGCGCTC-1	Epithelial
GTGCTTACATCAGCGC-1	Epithelial
GCAAACGTCGCCAGGT-1	Epithelial
AATAGAATCTGTTTCA-1	Pericytes
TCTCATGAGATAGGGT-1	Muscle
ATGACTATGCGACATT-1	Muscle
CCTAACCCAAACAAGT-1	Muscle
AGTCAAGATGACACTT-1	Fibroblasts
CGGGAGCTTCAGTGTA-1	Fibroblasts
CCACAGTACCCATCCT-1	Epithelial
GAGCGCGCACGAGTAG-1	Epithelial
ACCAGTGCGGGAGACG-1	Epithelial
TCCTTACGACGGTCCG-1	Epithelial
TAGTCGATCACGGGTT-1	Myofibroblast_Mesothelium
AGACGAAGTGCCGGTC-1	Epithelial
CGCTGGTGACTACCCT-1	Epithelial
AGGCATTGTCGTAGGG-1	Epithelial
TGGTAGAATATATGGG-1	Epithelial
TTCTTATCCGCTGGGT-1	Epithelial
AGTTTGGCACGGGTTG-1	Epithelial
GCATCGGCCGTGTAGG-1	Epithelial
ATGCGAGTCCCACCAC-1	Epithelial
TCGGCGAACCCAAACC-1	Epithelial
AGAGTAAACTTCACTA-1	Epithelial
AAGCCGAAGCGGTTTA-1	Epithelial
CCCGAGTTTCTCCGTA-1	Epithelial
AATATCGAATCAATGC-1	Epithelial
GCGCCTCCCACTCCGA-1	Epithelial
CGTTAAACTAGTTAGG-1	Epithelial
TGAGTTAAAGACATTC-1	Epithelial
AACAGGTAGTATGGAT-1	Epithelial
GAACGCGGGTCACACG-1	Epithelial
TGTTTGAGATCGTCAG-1	Epithelial
ATCTCGTGAGCGAAAC-1	Fibroblasts
CTGAGAAAGTTCGGCG-1	Epithelial
ATTACCACACTGCCTG-1	Neural
CTGCTGTCTAACGAGC-1	Epithelial
TTATCCGGGATCTATA-1	Muscle
CTGGAAGACACGGTGG-1	Muscle
GTTCGTCTAAAGAACT-1	Neural
GTCTATTGGTTCCGGT-1	Muscle
CTAGGCGCCCTATCAG-1	Fibroblasts
AACGGACGTACGTATA-1	Muscle
AACACACGCTCGCCGC-1	Epithelial
GCTACTATAGTAGAGT-1	Epithelial
AGCATATCAATATGCT-1	Epithelial
CGAACAGTATGGGCGT-1	Epithelial
ACAATTGTGTCTCTTT-1	Epithelial
GATCGCTACCCGATTT-1	Epithelial
ATTGCGATCAGTAACT-1	Epithelial
CAGCAGTCCAGACTAT-1	Epithelial
AGAGGCTTCGGAAACC-1	Epithelial
AAACAAGTATCTCCCA-1	Epithelial
GGCAGCAAACCTATGC-1	Epithelial
ACTAGTTGCGATCGTC-1	Epithelial
TTGGACCATCTGGCAA-1	Epithelial
CCCTCCTCGCTCGTAT-1	Epithelial
GAGCGCAAATACTCCG-1	Epithelial
ATTACATGTCAGTCTT-1	Epithelial
TTGGGACGTAAGAGTT-1	Epithelial
CTTCGGCCAATTGTTT-1	Epithelial
AGACCGCTCCGCGGTT-1	Epithelial
GACCGCGTCTGACGTG-1	Epithelial
CCAAATAACAAGATTC-1	Epithelial
TCTTTAGAGTCTAACA-1	Epithelial
CTCCCAATGAGTCGCG-1	Epithelial
TAGTCTTTCCGAATTG-1	Fibroblasts
GAGTAAACCGGAAAGT-1	Fibroblasts
GATCTCGACGCTGTGG-1	Epithelial
CTGACATAGAAATAGA-1	Epithelial
TATACCGAGTGCCACA-1	Epithelial
TCCGAACGTTGCCGCT-1	Epithelial
GCAGAAGGTAATCTCC-1	Epithelial
GGTACTAAGTGCTTTG-1	Epithelial
CAGAATATTCGTTATC-1	Epithelial
TAATCAACCAAATGGG-1	Epithelial
AACTGAGTTATACTGA-1	Epithelial
GCTATACGTCTCGGAC-1	Muscle
GAGCCAGCTACCTGTG-1	Muscle
TGCTAAGTGTCTATTT-1	Muscle
GTCCTACGAATAGTCT-1	Muscle
CAGTGTCGGCTGGCCC-1	Fibroblasts
CTATCGACGAAATACA-1	Fibroblasts
CATCATTACCCTGAGG-1	Epithelial
TAAGTTGCGACGTAGG-1	Epithelial
AGTGCACGCTTAAGAA-1	Epithelial
TGTGCCGGTGCCGGAA-1	Epithelial
AGGAGGCCTTCGCGCG-1	Epithelial
TCCGCGGCCCAATGAA-1	Epithelial
TCCGTTAAGCTAATAT-1	Epithelial
AAATCTAGCCCTGCTA-1	Epithelial
CGCAGGCGATCCAAAC-1	Epithelial
CCATATGGAAACTATA-1	Epithelial
CACCGTATCCCATCCG-1	Epithelial
GGTCAAGACTACTTCG-1	Epithelial
CCCGTTTCGCAGATGT-1	Epithelial
GTTATAATACGGTGAA-1	Epithelial
ACTTGTGGATGGAACG-1	Epithelial
GTTCGCTGAGACGTCT-1	Epithelial
GACACTGGAACCCGAT-1	Epithelial
CCCAGGTCTGAAGGCT-1	Epithelial
TCTCGAGGAGGTTCGC-1	Epithelial
ACTATCTGCCCGCGTA-1	Epithelial
CCTAAATTGTATCCTA-1	Epithelial
AGAAATTATGACTCGC-1	Epithelial
TCCAGCGCTATAAGCG-1	Epithelial
TCGTGTATTGGTCACG-1	Fibroblasts
CCACATACTGCACCCA-1	Epithelial
GTTGCGGACGGTCAGG-1	Fibroblasts
GTATTTAATGGCATAA-1	Immune
GTCGATAGGTGACTTT-1	Epithelial
AATAATCTTCGTATCG-1	Epithelial
ATTGTTCAACGATCCG-1	Epithelial
GTGCAGCGTAGAGTAG-1	Epithelial
TGTGGTAGGGTGCCTT-1	Epithelial
TGTGGACTATCTACGT-1	Epithelial
GGCGGGCTCTAAGAGT-1	Epithelial
CATGTAAGAGACATTT-1	Muscle
CACGTTTCGTACACAC-1	Muscle
CATCCTCTCAAAGATC-1	Muscle
GATTAACCGAAAGCCC-1	Fibroblasts
AACGCTGTTGCTGAAA-1	Fibroblasts
TTCAGCTGGCGTGCCC-1	Muscle
TAGAGGTTCTACTTGT-1	Epithelial
GTATCAAACGTTAGCT-1	Epithelial
AATCATGTAAAGACTC-1	Epithelial
AGTCACTAGCTCTCGA-1	Epithelial
GCGAAACGATCGGGAG-1	Epithelial
CATGGATTGTCTTCCG-1	Epithelial
ATTGGATTACAGCGTA-1	Epithelial
CACACACGCTAACGAG-1	Epithelial
CTATGGGAAGCGGAAT-1	Epithelial
TGCCTAATTGAAGATT-1	Epithelial
TGGCAATGGGACGGCG-1	Epithelial
ACCTCCGCCCTCGCTG-1	Epithelial
CGGCAATAAGATCGCC-1	Epithelial
CCTTGACCACTTTATT-1	Epithelial
TCATTTAGAAGTGTGA-1	Epithelial
CAGAATAACACACGGA-1	Epithelial
TCTGAGCAATTGACTG-1	Epithelial
CAACGTGGTGGAGTCT-1	Epithelial
CACAGTTCGCTTCCCA-1	Epithelial
TCTCTCGCCGCACATA-1	Epithelial
TGGGCAGGCCACCGCA-1	Fibroblasts
CTCCTGTTCAAGGCAG-1	Fibroblasts
TATTTGATTTGCACAG-1	Fibroblasts
GCCACTCCTTACGGTA-1	Endothelium
ACCGATATTTAATCAT-1	Epithelial
TTATTATCTGGAAGGC-1	Muscle
TACATGCCGGAATTGT-1	Epithelial
GGCACTCAGCCGACCC-1	Neural
AAACCGGAAATGTTAA-1	Epithelial
AGACAGGCATCTCAGC-1	Neural
GTGGTGATGGTTTGTG-1	Epithelial
CCGATATGACGTAAGG-1	Neural
AGTCGTCGACCACCAA-1	Endothelium
TCCTTTAAATCCGCTT-1	Neural
ACTGAAACGCCGTTAG-1	Muscle
GCACACACTGGTAGCC-1	Endothelium
TAAGGGCCTGTCCGAT-1	Fibroblasts
GCTAGAGTAGAGATGT-1	Muscle
CACAGGGCCATATAGT-1	Epithelial
CCATGCCCTAGATTTC-1	Epithelial
TCGCGTAGCAGTGTCC-1	Muscle
GACGAGGCTAATAAAC-1	Epithelial
CTACACTCGCAGATGG-1	Epithelial
ACGCATACGTTTACTA-1	Epithelial
GGAGCAACATTTCAAG-1	Epithelial
CGAGAGGGTAGCCGCG-1	Epithelial
TCGTGTTCGACCACAA-1	Epithelial
TCTACCCAATAGAGAG-1	Epithelial
ATAAACGTTGCACCAC-1	Epithelial
TCAACTGCAGAGTCAG-1	Epithelial
AGCTCCATATATGTTC-1	Epithelial
GTAACATCTAAGATAA-1	Epithelial
CCGACAATAGGCCGCC-1	Epithelial
ATGCTTAGGAGTTGAT-1	Epithelial
AACCCGAGCAGAATCG-1	Epithelial
CGGGTTTGTTAGGGCT-1	Epithelial
AGGCACGTGACTGTCC-1	Epithelial
GACAAGAGATGAGATT-1	Epithelial
AGCCCTTGGACATCCC-1	Fibroblasts
GCAGTTCGATCCGAGC-1	Fibroblasts
TCGAGGGCAACAGACG-1	Fibroblasts
ACTTTGTCGACGCACT-1	Epithelial
GAGTATCAAAGTTACA-1	Muscle
CCAGGCTGGCGTCTGA-1	Neural
GGACTCTTCCGGTTGA-1	Neural
TCCCAGCACACGACAT-1	Muscle
GCTCCATGAGTGCAGA-1	Neural
GCAGTGCGGGCGGATG-1	Neural
GCGTTCTGACTAAGCG-1	Neural
ATATCGTTCCTCGAAC-1	Muscle
CGGCGCCATCAATCCC-1	Muscle
CCTGTTTGAAGACACG-1	Muscle
GCCACTCAGAGCGCGA-1	Muscle
TCGGCTTGTATCGACG-1	Fibroblasts
TAGATGGTTCCTTACT-1	Fibroblasts
ATCGTTAGCTAGCGGA-1	Epithelial
ACAGCGACATTCTCAT-1	Epithelial
ATTCAACCATTTAAGG-1	Epithelial
CACTCTTCTGCTAGCC-1	Epithelial
CTAACTGATAATCGCC-1	Epithelial
TGATGTCAATTAAGTG-1	Epithelial
CGCCGTTCAGCATAGT-1	Epithelial
ATACTACCCGTACCAC-1	Epithelial
CCACTGTTTGGATTAA-1	Epithelial
CACTACGGGAGCTGCC-1	Epithelial
GACCAAACGTTGACTG-1	Epithelial
AAGAGGCCCTTTGGAA-1	Epithelial
ACACGTAGGCCACAAG-1	Epithelial
TACTCTTACTTTACTG-1	Epithelial
AGAGCCGCCGAGATTT-1	Epithelial
GGCCTGCTTCTCCCGA-1	Epithelial
TCAAGCGCGGACGGTA-1	Epithelial
ACACTGGGACAGTCGT-1	Epithelial
TGTGTAGTAGCACGTG-1	Epithelial
CTAGCCACAGGCGAGC-1	Fibroblasts
CTATCGCGTAGAGAAC-1	Fibroblasts
GTTCCCGTAAACATAT-1	Epithelial
TCTTTCCTTCGAGATA-1	Fibroblasts
ATATTGGAGAGGCCTT-1	Epithelial
AGGCGATAACTGGCGT-1	Muscle
ACCCGGAGCACCACAA-1	Neural
TGAGCTCAACTGTATA-1	Neural
ACGACCCATGAGTTGC-1	Neural
CGGTCAGTCCATATTT-1	Neural
TCCGGCTGTCGGGTCG-1	Neural
CTTTGCATCGCTCTTG-1	Neural
TCACAAACCGAGGTAC-1	Muscle
CCGTAGGAAATCCCTG-1	Neural
AAACATTTCCCGGATT-1	Fibroblasts
GCCTCCGACAATTCAC-1	Fibroblasts
TCTGCATACCTTGCTT-1	Fibroblasts
ACCCATTTGTCCCTCT-1	Fibroblasts
CTGCAGAGAATCAGAG-1	Epithelial
GGAAACTAAATGGGCC-1	Epithelial
CAACCTACCGAGCAGT-1	Epithelial
CCGTAGGGTTGTTTAC-1	Epithelial
GGTTTGTGACCTGAGG-1	Epithelial
TAACCTAGGGAGTCCA-1	Epithelial
TTCCATCGACAGCGTG-1	Epithelial
ATCTCCCACGGAATAT-1	Epithelial
GTTTCAAACGAGTTGT-1	Epithelial
GGAACTTTGGCGATTA-1	Epithelial
CTGCAAGCACGTTCCG-1	Epithelial
CACAGTCCCGCTTCGC-1	Epithelial
TACGCTCGGTATTGGA-1	Epithelial
CTGGTAAAGTGTGGGC-1	Epithelial
CAACCAGTGGCCTACC-1	Epithelial
TCTTCGCGGTGAGAGG-1	Epithelial
TTCGGGTTGCCACGGG-1	Fibroblasts
ACCGATAGGCATAACC-1	Epithelial
CTTATAGATGGCTGTT-1	Epithelial
AGACGCCCACTTCGCC-1	Epithelial
AGGTCGCCTCCCAACA-1	Neural
CCTCACGTCAGCTAAT-1	Muscle
CCACCTGTATGGAATA-1	Muscle
GGACTCGAAGCTTTCA-1	Neural
AAGCCGGAGAGCAGGA-1	Neural
GCCTATCAGGTAAGAT-1	Neural
TCAGAGTGTGAGCATG-1	Neural
CCTCCTGTTGTGTCGT-1	Neural
ACAAAGCATGACCTAG-1	Muscle
ATAGCAACTAGGGAAG-1	Muscle
CCGCTCTTCCGAACTA-1	Muscle
TAGAATAGCCGATGAA-1	Muscle
GGTCTCCGTCCAGGTT-1	Muscle
TAATTACGTCAGTAGA-1	Epithelial
TACGTAAAGCGGAGTG-1	Epithelial
GCTACAATCGAGGATA-1	Epithelial
TCAGCCAATCCGTAAA-1	Epithelial
ATCATAGCCCTATGTA-1	Epithelial
GAGGCCTGTTGATACA-1	Epithelial
ATATACGCTCGTGACG-1	Epithelial
CCCTTTAATGGAGTTC-1	Epithelial
TTACACGATCTGCGAC-1	Epithelial
TCGCATAAAGGGCGCA-1	Epithelial
TGTAGCCATCCCATTC-1	Epithelial
GGGTCTATCGCTTTCC-1	Epithelial
GGAGGGTCAAGTAAGA-1	Epithelial
TACGGCATGGACGCTA-1	Epithelial
CACGTCAATCAATGGA-1	Epithelial
CGCTTGGACGGATAGA-1	Fibroblasts
CGCGGTACGGTATACA-1	Fibroblasts
CCTACTCAACACGATT-1	Epithelial
CGTTTGGTGTTGTGGG-1	Epithelial
GTTGTTGCAAGATGGC-1	Epithelial
CATTCGTCGTAGCGGT-1	Neural
CAGCCTCGATAGCGGT-1	Neural
TCATAAGTCCAAGAAG-1	Neural
AAAGTGCCATCAATTA-1	Neural
GTTGCAGTCGACAACA-1	Neural
TAAATGGGCTACTGAG-1	Neural
GTCATGCGCGAGGGCT-1	Muscle
TAGGCTAAAGTGGCAC-1	Muscle
TGGCTACACTCTACCT-1	Neural
TGTCCACGGCTCAACT-1	Epithelial
AATTGCAGCAATCGAC-1	Fibroblasts
GTCAACCAGGCCTATA-1	Fibroblasts
ATCTTATCGCACACCC-1	Fibroblasts
GTCTATTGCATGCTCG-1	Fibroblasts
GCACGTGGTTTACTTA-1	Epithelial
ATTCGCGCCTTGAGAG-1	Epithelial
AGCGATGCGCCTAATA-1	Epithelial
TCTATAGGTGGGTAAT-1	Epithelial
AGATACCAATAGAACC-1	Epithelial
CGTGTATGGGAGCTGA-1	Epithelial
ATGTACATGCGGTGAG-1	Epithelial
TTGGCTCAATATGTGT-1	Epithelial
GTTCGGAGCACTCAAC-1	Epithelial
TCCCTCTTCTCAAGGG-1	Epithelial
TTACGTATCTATGACA-1	Epithelial
CCCATATAGGTCGATT-1	Epithelial
GTCCACGTCGCATTCG-1	Fibroblasts
AATTGTGGTTGCCAAA-1	Fibroblasts
AGGAACGAACGACTTC-1	Neural
TAATTCCAATGCTTCA-1	Epithelial
AGGGCCCTAATGTTCT-1	Muscle
AGGTGTTGCCGACCAC-1	Muscle
CTGAGAGTAGAAATAC-1	Neural
TAGAAGAAGGGTTACA-1	Muscle
GGTGACTGATAGAGAG-1	Neural
TACCCTCGGTAACCCT-1	Neural
CAGATAATGGGCGGGT-1	Neural
GAGAACGGTTCTGACT-1	Muscle
CGCTTCGGTCTAAGAC-1	Fibroblasts
AGCATTACGAGGCAAG-1	Muscle
AAGTTGTGATGTTATA-1	Fibroblasts
TTGCTCATAGTACGTG-1	Fibroblasts
TACTTAAACATGTACA-1	Fibroblasts
AGTGAGTCGAATTAAC-1	Fibroblasts
TAGGCCTATATAGTCT-1	Muscle
ACTCGCCGTTCGATAA-1	Epithelial
GGTACGTTGCGGCCGG-1	Epithelial
TATTGCCGGGCTTGTA-1	Epithelial
GGTAAACTCTGCGCTG-1	Epithelial
TCCCTTGTCTGAAACT-1	Epithelial
CATGATCGCTTTGAGA-1	Epithelial
GGACGGGCGACCAACC-1	Muscle
GAGAGGCCTATGTGTA-1	Epithelial
TCGTAACTCCCAAGAC-1	Fibroblasts
CGTATCTAGAACTAAG-1	Fibroblasts
GCACCTTCCCGAAGGT-1	Muscle
TACCTCTTTACCATCC-1	Muscle
TGACTCTAACTGGTAA-1	Muscle
GAGAAACTGGATCCCA-1	Muscle
ATCCGGACCAGCCTGA-1	Muscle
TTATTTAGGTTCCTTA-1	Immune
CGAATTCCCGGTTCAA-1	Muscle
TTGCCTTCTCGCCGGG-1	Neural
TTAAAGTAAGTCGCCA-1	Neural
AGTTGGCAAGGCTAGA-1	Muscle
CCGCACTTGCAATGAC-1	Muscle
AATGTTGTCGTGAGAC-1	Fibroblasts
CCAAGGTTGCCCTTTC-1	Muscle
TGTGACTAGAGTTTGC-1	Muscle
TTGTGATCTGTTCAGT-1	Fibroblasts
GGAGTTGATTCTGTGT-1	Epithelial
GTAGTGAGCAACCTCA-1	Fibroblasts
AAGACATACGTGGTTT-1	Epithelial
CATCCCGAGATTCATA-1	Muscle
GGCCGCAGGAACCGCA-1	Fibroblasts
CCAGAAACTGATGCGA-1	Fibroblasts
ACCCGTAGTCTAGTTG-1	Epithelial
AGGGTCTGGACGCAGT-1	Fibroblasts
TTGAAACCCTCATTCC-1	Fibroblasts
TCAATCCCGCGCCAAA-1	Muscle
AGGACATCGGCACACT-1	Muscle
GACAAGACGCCCGTGC-1	Muscle
GAGTAAATTAAGAACC-1	Neural
TAAGTCGGTGAGCTAG-1	Endothelium
CTTACTGACTCCTCTG-1	Neural
TTAACTGATCGTTTGG-1	Neural
AGGTGCACGTCCACAT-1	Muscle
ACCAAGTCATCGGCAG-1	Muscle
AGTAACTATAGCAGCC-1	Endothelium
GGGAAAGAATGCCAAC-1	Neural
AATCGGTATAGCCCTC-1	Muscle
GGCACTGCGGTGGTTT-1	Muscle
CGTCCTCATCGCGTGC-1	Muscle
CTTAACTTACAGTATA-1	Muscle
GTGAGTCGACTAATAG-1	Muscle
TGTACTTCCGGGCATG-1	Fibroblasts
CACAAACCGCAGAACT-1	Epithelial
GCTTTACACAACTGGG-1	Muscle
CACCGATGATGGGTAC-1	Epithelial
TCAATATACAGGAGGC-1	Muscle
AACGACCTCCTAGCCG-1	Muscle
GTTACCAAGGCGTACG-1	Muscle
TAGCTCACTGTGTTTG-1	Muscle
TCGGCAGGGTTAAGGG-1	Neural
TGTTAACAAAGTGACT-1	Neural
CAGAGCGATGGATGCT-1	Neural
CATAGTGGGCACGCCT-1	Neural
AAACGCTGGGCACGAC-1	Neural
TGTTCTCATACTATAG-1	Neural
TCCACCAAGACATAGG-1	Fibroblasts
GTCTCCCGAGTCCCGT-1	Muscle
GGCACGCTGCTACAGT-1	Muscle
GCTTGAGTGACCTCTG-1	Muscle
ATAGCCATAACAGTCA-1	Muscle
TAGGAGGCTCGAGAAC-1	Muscle
GTCGGGTGAAGTACCG-1	Muscle
CACCCGCGTTTGACAC-1	Muscle
TCTCAGGCTACTCGCT-1	Muscle
TAGATTCTCTAGCAAA-1	Muscle
CCCATTATTGTATCCT-1	Muscle
GTTAATAGCGTCATTA-1	Muscle
TACTCATTGACGCATC-1	Muscle
TAGTGACAAGCTCTAC-1	Muscle
ATCGCCGTGGTTCATG-1	Neural
CTGCTCTCAACACACC-1	Muscle
GCATGACACAAAGGAA-1	Neural
GTCTTACCACGCCAAG-1	Neural
CGTTTCGGTTATATGC-1	Muscle
CGTTAAATACGACCAG-1	Muscle
ACGCTACTGAATGGGC-1	Muscle
